小区北门保安强制收取停车费用	保安不当行为
楼道内存放垃圾桶存在安全隐患问题	安全秩序没保障
物业增加小区垃圾桶异味扰民，希望取消#市政府门户网站互动交流平台#	管理简单粗暴
物业不履行职责	态度与规范
村内监控无法使用导致村民安全没有保障	监控实施损坏
碧桂园A区3号楼3单元的单元门锁故障问题#微博私信#	日常服务不到位
停车场乱收费“12315热线来电”	收费不合理
物业私自动用公共维修基金	缴纳与监管
物业保安不让自己汽车进小区	日常服务不到位
物业私自挪用公共维修基金问题	缴纳与监管
物业费交费规定不合理的问题	物业费
车辆被砸无人管问题	管理简单粗暴
金源泉小区业委会人员不作为	受破坏及法律权益保障
路长街居委会不让居民在小区内停车	安全没保障
小区安装摄像头的问题。	申请与使用
林校北里不让安装充电桩	申请与使用
石门苑17号楼4单元单元门故障	日常服务不到位
希望在老山西里小区37号楼一单元门口楼内安装监控	监控实施损坏
核实停车位置规划是否合理	安全没保障
物业不让安装充电桩	质量和水平
小区内停车秩序混乱	秩序混乱
小区开发商出售地下车位价格高，业主对此意见大	管理费
投诉望京街道不作为	态度与规范
物业不给开供暖收费发票问题	自供暖社区供暖费
处理物业不让自己缴纳供暖费的问题/保密	自供暖社区供暖费
希望小区门口可以加设拦车杆#微博私信#	秩序混乱
小区监控未修复	监控实施损坏
建议安装摄像头	安全秩序没保障
投诉物业不清理雪	态度与规范
物业另收取费用不合理	管理费
物业私自涨物业费不合理	物业费
物业私涨停车费，居民对此意见大	管理费
物业充电度数过少	缴纳与监管
小区物业保安队长服务态度不好	日常服务不到位
物业收取装修垃圾清运费不合理	垃圾清运费
物业事先未征得业主同意，私自使用公共维修基金维修楼顶，业主对此意见大	申请与使用
协调维修门禁	日常服务不到位
希望相关部门对消融学校经常开小区东门的问题进行加强管理	安全秩序没保障
非机动车车棚无人看守的问题	安全没保障
自家水表箱被锁	管理简单粗暴
物业是否有权利收取装修物业费管理费	管理费
任职不合理	组织、推选
希望相关部门解决自己交水费和房费物业不收的问题	缴纳与监管
咨询居委会和业主委员会是否同为政府基层的群众组织	组织、推选
违规停车	秩序混乱
十万平小区摄像头不开放	监控实施损坏
希望小区加强管理外来车辆进入	秩序混乱
希望增设监控摄像头问题	安全秩序没保障
协调更换单元门	安全秩序没保障
收取物业费不合理的问题	物业费
投诉朝阳医院安保人员态度恶劣	保安不当行为
物业未经业主同意私自上涨垃圾费和物业费等居民对此意见大	物业费
小区保安不作为	保安不当行为
物业帮助业主私自接小区公共用电为业主安装摄像头	监控实施损坏
拆除小区大门安装停车杆不合理问题	安全秩序没保障
龙旺同心物业收取高额物业费，暴力威胁小区业主	管理简单粗暴
田村路街道办事处不配合小区投票事宜延期问题	权力运作及监督
小区门禁故障无人维修问题	监控实施损坏
能否增加停车棚	安全没保障
物业不尽责/保密	态度与规范
物业迟迟不退装修押金	管理费
物业胡作非为问题	管理简单粗暴
小区设计大门不合理问题	质量和水平
投诉路劲（北京）物业管理有限公司收费及要求购买指定建筑材料等不合理	垃圾清运费
物业收取费用不合理	垃圾清运费
希望尽快成立小区居委会	组织、推选
小区物业安装阻拦杆，影响周边居民正常生活（要求转接领导）	秩序混乱
停车安全没保障	安全没保障
物业涨热水价格不合理的问题	物业费
 物业追缴供暖费不合理的问题	自供暖社区供暖费
集装箱安放位置不合理	申请与使用
物业不管理小区的绿地更改位停车场	秩序混乱
物业收取中水费不合理‘’12315热线来电‘’	物业费
希望小区物业合理规划小区车位阻止外来车辆进入	秩序混乱
物业禁止快递进出小区，影响业主收快递/保密	入户维修态度及质量差
物业要求业主缴纳装修押金及垃圾清运费，居民对此意见大	垃圾清运费
使用公共维修基金费用高问题。	缴纳与监管
小区摄像头故障	监控实施损坏
小黄庄居委会不开具监护人证明	权力运作及监督
建议新华里10号院增设监控设备	监控实施损坏
希望给小区门口安排站岗人员	安全秩序没保障
屋内被淹后物业迟迟不处理问题	质量和水平
村内监控无法使用导致村民安全没有保障	监控实施损坏
小区内环境脏乱差	质量和水平
375号文件是否还有效力、如果有按照文件执行、街道介入	组织、推选
小区变成公共停车场是否合理	安全没保障
东城区交道口街道禁止共享单车进入胡同不合理的问题	日常服务不到位
居委会擅自在小区举办商业活动的问题	权力运作及监督
监控损坏居委会未及时修理问题	监控实施损坏
投诉停车管理公司私自涨价	收费不合理
希望安装一个坐便马桶的问题	申请与使用
居民楼门禁故障，希望尽快维修	安全没保障
小区起名不合理问题	申请与使用
协调租地下室的问题	质量和水平
希望更换门窗玻璃	安全秩序没保障
房山区长阳镇碧桂园小区物业工作不到位问题	安全没保障
物业不退公共维修基金不合理	缴纳与监管
业委会动用公共维修基金用途的问题	权力运作及监督
小区物业设置门禁没有起到作用	日常服务不到位
租户把公共区域占为己有	入户维修态度及质量差
私人车位被占无人处理	安全没保障
断水电问题	威胁恐吓业主
希望小红门乡政府为恋日绿岛小区业主委员会备案#微博#	受破坏及法律权益保障
协调物业出具物业费涨价业主确认签字书问题	物业费
 小区内环境差无人清理	垃圾清运费
不按标注价格收费	管理费
取消入户拉票的方式炒物业的问题	质量和水平
居民未带门禁卡，物业阻止进入小区，希望灵活管理	入户维修态度及质量差
当代城市家园业主大队投票弄虚作假的问题	权力运作及监督
物业不服务业主不作为	日常服务不到位
建议在原香漫谷小区内设立居委会	组织、推选
小区收取供暖费过高，居民对此意见大	物业费
小区给租户办门禁微信授权收费问题#微博私信#	管理费
中控室工作人员擅自离岗	工作效率低
了解两限房停车场收费价格是否合理	收费不合理
小区内乱停车的问题	秩序混乱
不要换窗户把换窗户的钱用来安装电梯	申请与使用
物业安装热水加热器不合理	日常服务不到位
小区没有物业的问题	申请与使用
建议安装摄像头问题	监控实施损坏
投诉大西洋新城保安不当行为	保安不当行为
单元门禁损坏#评论#	安全秩序没保障
成立业委会困难的问题	组织、推选
住宅小区商业化问题/保密	管理简单粗暴
小区内随意堆放生活垃圾，希望清理	质量和水平
希望街道能尽快给业委会备案	权力运作及监督
物业不给安装充电桩	质量和水平
小区内上调物业费的程序违规	物业费
杨屯矿物业收取手工费不合理	物业费
物业无故不让自己车辆进入小区不合理	态度与规范
外来人员在小区内收取停车费，没有备案手续，希望查处	安全没保障
无法交电费	日常服务不到位
小区业委会管理混乱	权力运作及监督
居委会主任恐吓自己母亲的问题	管理简单粗暴
供暖公司不让停暖。	自供暖社区供暖费
物业没有通燃气的情况下就让收房不合理以及态度恶劣	保安不当行为
市民反映单元门坏了无人修	入户维修态度及质量差
物业不退还装修押金	管理费
不正规物业	管理费
小区内停车秩序差，希望加强管理	秩序混乱
天秀花园古月园小区开发商不给瑞赢物业提供办公场所不合理	管理简单粗暴
物业贴单子不合理的问题	保安不当行为
监控不能用	监控实施损坏
小区中控室被锁死	安全秩序没保障
车辆占用小区消防通道问题	秩序混乱
开放东门不合理	安全秩序没保障
希望尽快成立业委会问题	组织、推选
投诉物业不卖水	态度与规范
物业捆绑收费不合理	物业费
物业保安不让业主开车进小区	秩序混乱
希望成立业委会	组织、推选
协调帮助成立业主委员会问题	组织、推选
冯石环路414号院停车收费不合理问题	收费不合理
私自加装护栏	安全秩序没保障
车被人恶意划伤问题	安全没保障
物业停水、电、电梯强行收费问题	管理费
东城区环卫工作人员不合理收费	垃圾清运费
小区物业无理由阻拦车进小区	管理简单粗暴
物业不作为	威胁恐吓业主
小区停车位只售不租	收费不合理
强行收取物业费	物业费
往自家扔垃圾	质量和水平
希望小区增设监控探头	监控实施损坏
电梯内有异味物业不管	入户维修态度及质量差
小区物业强迫市民交车位费问题	管理费
建议拆掉内围墙【北京市委书记蔡奇】#人民网地方领导留言板#	态度与规范
物业不让安装充电桩，导致居民无法给新能源电动车充电	申请与使用
核实了解一下突然涨价是否合理	自供暖社区供暖费
物业乱作为态度差未经同意进入自家维修问题	态度与规范
居民拿钱维修公共设施不合理	申请与使用
占用消防通道开设店铺，存在安全隐患	秩序混乱
未经业主同意，物业私自收取楼道照明灯电费，业主对此意见大	管理费
村大队不让进快递车问题	保安不当行为
建议物业晚上不要开弥红灯的问题	安全没保障
居委会主任违规出租房屋的问题	权力运作及监督
沿海赛洛城小区南社区书记不履行职责	权力运作及监督
私自涨物业费问题	物业费
核实香海园小区住宅维修资金是如何进行审批和公开招标的	申请与使用
小区车位管理费收费太高	管理费
撤销反映	安全秩序没保障
撤销投诉	安全没保障
物业收费不合理	垃圾清运费
物业收取停车费不合理“12315热线来电”	管理简单粗暴
相关部门尽快帮助处理和平里街道办事处综合治理部门至今不给安装摄像头	监控实施损坏
小区停车场经营权非法转移#微博私信#	收费不合理
希望在小区加装摄像头	监控实施损坏
物业无资质乱收停车费，业主对此意见大	物业费
物业费太高	物业费
马路边乱停车	秩序混乱
希望星河湾双语幼儿园不被改成普惠幼儿园	安全秩序没保障
物业乱收物业费	物业费
小区物业不作为问题	入户维修态度及质量差
市政燃气改造的问题	安全秩序没保障
物业乱涨物业费不合理问题	管理费
物业未入户维修客厅灯	入户维修态度及质量差
京东借条报通讯录的问题	威胁恐吓业主
着火问题#微博评论#	安全秩序没保障
小区内监控设施损坏，希望及时维修	监控实施损坏
全封闭护栏不合理	安全秩序没保障
监控故障存在安全隐患	监控实施损坏
物业停车收费不合理	收费不合理
业主私占停车位，导致其他居民停车不便	秩序混乱
物业私吞了噪音扰民费问题	管理费
 应急物业不撤出小区	质量和水平
收费不合理	管理费
安装充电桩的问题	申请与使用
小区开后门后经常有学生和车辆穿行，希望封闭管理	管理简单粗暴
乱收公共维修基金	缴纳与监管
小区内车辆乱停乱放无人管理问题	秩序混乱
市民要求投诉宝山委员会阻挠小区成立业主委员会的问题	组织、推选
投诉物业管理差	态度与规范
小区安保不到位问题	保安不当行为
停车费用收取不合理	收费不合理
物业不让搬家公司车进小区	态度与规范
物业费缴纳时间不合理“12319热线来电”	物业费
物业不给验房不退押金不合理	管理费
小区物业把小区立体车车库对方开放不合理问题	安全没保障
物业捆绑收费不合理的问题	物业费
莱圳家园小区业主管理的公共收益资金一直被物业非法侵占#APP#	组织、推选
物业不作为	态度与规范
物业保安服务差	保安不当行为
投诉物业不作为	管理简单粗暴
 物业试暖未提前通知，导致居民家中被泡，希望协调处理	态度与规范
辅路监控设施不完善	监控实施损坏
希望更换楼管员	入户维修态度及质量差
通州区西集镇运潮馨苑小区的保安	保安不当行为
小区6号楼6单元1层楼道内停放电动自行车存隐患，希望尽快挪移车辆	安全秩序没保障
希望停车场摄像头照着停车场	监控实施损坏
单位收取卫生费不合理	垃圾清运费
北京华清物业管理有限公司高额收取供暖费不合理	自供暖社区供暖费
物业不清理垃圾	质量和水平
废旧自行车电动车私占停车位	秩序混乱
希望安装摄像头	监控实施损坏
楼上业主私改供暖管道跑水问题	管理简单粗暴
投诉国豪物业	质量和水平
小区存在很多问题	日常服务不到位
物业收垃圾清运费	垃圾清运费
小区监控设施拍不清车牌号问题	监控实施损坏
小区脏乱差问题	管理简单粗暴
小区存在高空抛物	安全秩序没保障
迎喜家园小区物业施工不合理问题【北京市委书记蔡奇】#人民网地方领导留言板#	缴纳与监管
社区管委会不作为	工作效率低
小区内多处监控故障	监控实施损坏
小区用900万做防水工程不合理	权力运作及监督
物业不作为	日常服务不到位
物业关太阳能无法使用	管理简单粗暴
希望撤销现有业主委员会#市政府门户网站互动交流平台#	组织、推选
小区地下车库没人管理问题	安全没保障
小区存在安全隐患问题	安全秩序没保障
2期物业收取水费不合理	物业费
碣石坪15号楼业委会强制破拆道路围墙的问题#微博# 	权力运作及监督
充电桩收费	管理费
物业管理不规范的问题	安全秩序没保障
小区保安随便放进人	安全秩序没保障
小区大门门禁系统故障，影响居民出行/保密	态度与规范
未经业主同意，海淀区园林局强制将小区内公园改为公共绿地并对外开放，居民对此意见大	入户维修态度及质量差
物业不作为等问题	威胁恐吓业主
投诉物业	态度与规范
花园停放汽车不合理	秩序混乱
物业提供停车系统无法识别车辆问题	质量和水平
物业乱收费	管理费
物业乱收费问题	管理费
收取可回收废品	垃圾清运费
北京市反诈骗中心封停手机号“12319热线来电”	工作效率低
物业服务质量问题	态度与规范
小区内停车混乱的问题	秩序混乱
清苑嘉园安装栅栏不合理	申请与使用
涉及物业问题#微博#	态度与规范
北京索菲特大酒店保安无健康体检证#市政府门户网站互动交流平台#	保安不当行为
和平里街道办事处综合治理部门至今不给安装摄像头	安全秩序没保障
帮助使用北京业主APP	受破坏及法律权益保障
希望在小区内增设探头进行全覆盖	监控实施损坏
小区管理混乱	日常服务不到位
希望清理青桔的共享单车	质量和水平
物业没有经过业主的同意更改了小区的物业费收费标准	物业费
小区停车物业实行双标准收费且收费价格高，希望尽快解决	收费不合理
物业涨物业费不合理	物业费
希望小区内的平房和楼房一样享受维修的待	申请与使用
投诉物业公司乱收费	垃圾清运费
物业不使用维修基金维修房门不合理	申请与使用
希望帮助协调安装摄像头	监控实施损坏
私自动用维修基金	申请与使用
迟迟不给物业备用门禁卡	日常服务不到位
公寓是否要交公共维修基金	缴纳与监管
物业收费不合理	管理费
投诉物业保安经理服务态度差	态度与规范
华油燃气营业点下班时间过早	工作效率低
明春苑小区东园物业不给更换阀门	日常服务不到位
未与业主协商在电梯间安装广告不合理问题	态度与规范
私自改装/保密	管理简单粗暴
核实封锁自行车棚不合理问题	安全没保障
物业不修缮楼道的问题	入户维修态度及质量差
希望开发商尽快退还公共维修基金	缴纳与监管
物业私自安装闸机	权力运作及监督
缴纳公共维修基金不合理问题	缴纳与监管
私自占用公共车位	秩序混乱
咨询物业动用维修基金是否需要业主签字	物业费
反映物业不作为和选择性作为的问题	态度与规范
希望物业加强对小区的管理	日常服务不到位
物业管理停车秩序混乱	秩序混乱
门禁损坏	日常服务不到位
恩济庄派出所不作为	管理简单粗暴
居委会阻挠成立业主居委会的问题	组织、推选
物业要装修保证金不合理	管理费
投诉周庄家园南里物业	收费不合理
卫生费不合理	物业费
物业不作为问题	物业费
希望北辰福第小区安装监控	监控实施损坏
小区收停车费不合理问题	管理费
物业强制收取维修金	管理费
翠微北里小区没有摄像头	监控实施损坏
停车难的问题	秩序混乱
停车场紧挨着居民楼建设不合理	安全没保障
安全秩序没保障	安全秩序没保障
物业不派人员清扫导致胡同脏乱差	日常服务不到位
地下停车场与商业街通道门位置不合理	安全没保障
和平里街道办事处综合治理部门至今不给安装摄像头	监控实施损坏
维修基金被动用	申请与使用
未经业主同意，物业私自动用公共维修基金，业主对此意见大	缴纳与监管
核实地下车库性质	安全没保障
希望帮助协调原来物业的撤出	受破坏及法律权益保障
雅苑地杰物业侵占业主共有车位#市政府门户网站互动交流平台#	保安不当行为
核实安装摄像头时间	监控实施损坏
物业选举居委会不正规	组织、推选
楼道内停放电动车和摩托车存在安全隐患/保密	安全秩序没保障
柜子清走无人处理	安全秩序没保障
石景山区古城街道古城南街9号院（绿地金融城）开发商不让业主车辆进入小区问题	管理简单粗暴
物业费太高不合理问题	物业费
物业收费不合理	管理费
物业公司重叠收取物业费	物业费
希望相关部门帮助解决招开临时业主大会	权力运作及监督
地下室积水存在安全隐患	安全秩序没保障
中国农业科学研究院后勤服务中心物业管理中心不作为	入户维修态度及质量差
未经业主同意，物业私自使用公共维修基金，业主对此意见大	申请与使用
不让安装新能源汽车电桩	安全没保障
防盗门损坏修理后不给钥匙的问题	权力运作及监督
停车秩序混乱	秩序混乱
希望把爱心募捐箱移动显著位置	管理简单粗暴
投诉业委会非法操纵业主大会选定物业	权力运作及监督
居委会不作为	组织、推选
楼道内存在杂物希望尽快清理	日常服务不到位
迟迟未给退装修押金问题	管理费
棕榈泉国际公寓保安未及时让自己访客	日常服务不到位
选择物业希望以票数最多的选而不是流标	组织、推选
核实物业向自家单位收取空调维修费是否合理	管理费
物业私自把小区业主的车辆的信息从小区电子台杆中删除	质量和水平
小区内停车乱	秩序混乱
不给业主家安装对讲机及门禁卡频繁出现故障	日常服务不到位
核实未经自己同意能否动用自己的公共维修基金	申请与使用
街道未按程序帮助小区成立业委会	组织、推选
物业管理设施不合理	安全没保障
物业私自动用小区消防设施，希望帮助处理	管理简单粗暴
物业费过贵	物业费
小区物业乱收费问题	管理费
核实没有房本是否应该交物业费	管理费
物业不退还多收物业费的问题	质量和水平
绿地杂草多树叶落地无人清理	日常服务不到位
123号楼监控安装未启用	监控实施损坏
能合理明确把第一家物业投票选举结果公布出来	组织、推选
物业不履行职责	入户维修态度及质量差
小区内安装栏杆影响通行，希望尽快拆除	日常服务不到位
希望安慧里三区物业公示收费依据并与业主签订合规的物业合同	物业费
希望尽快处理外部社会车辆的进入	日常服务不到位
小区所属居委会	组织、推选
小区物业不管理小区	入户维修态度及质量差
占用消防通道停车	安全没保障
业主把接线板伸入窗外充电存在隐患	安全秩序没保障
单元门禁损坏#评论# 	安全秩序没保障
龙泉镇三家店水泥厂宿舍大院9排6号摄像头未打开	监控实施损坏
东湖街道阻扰小区成立业委会	组织、推选
劲松八区没有保安的问题	保安不当行为
物业费高问题【北京市委书记蔡奇】#人民网地方领导留言板#	物业费
垃圾收费过高问题	垃圾清运费
街巷保安人员不履行职责	保安不当行为
希望小区更换物业问题	日常服务不到位
人员聚集感到人身有威胁	保安不当行为
小区内停放外来车辆不合理	秩序混乱
投诉物业不履行职责	管理简单粗暴
小区内停车秩序混乱问题	秩序混乱
希望尽快成立业委会	权力运作及监督
开发商拖着不给办理变更房主信息，希望及时解决	日常服务不到位
小区无物业	日常服务不到位
业委会乱作为问题	权力运作及监督
三轮车以及汽车占用小区停车位不开走问题	秩序混乱
开发商不配合提供资料，导致小区无法成立业委会，希望帮助协调	组织、推选
迟迟未退面积差问题	缴纳与监管
协调成立居委会（12 ）	组织、推选
小区物业的保安日常服务不到位	保安不当行为
小区物业大型维修基金的数额希望进行明确花费公示/保密	缴纳与监管
按照楼层高度收取供暖费不合理	自供暖社区供暖费
尽快修路	安全没保障
小区内治安差，希望安装监控设施	监控实施损坏
物业收取垃圾燃烧费不合理，居民对此意见大	垃圾清运费
希望惠民家园2区加设充电桩	申请与使用
让缴纳电梯费不合理	管理费
西潞街道不让成立业主委员会	组织、推选
物业卡着不交停车费的业主出小区	秩序混乱
物业工作质量问题“12369热线来电”	质量和水平
加强管理租户随意在步行梯里随地大小便情况“12315热线来电”/保密	日常服务不到位
建议安装个摄像头	监控实施损坏
取消业委会	权力运作及监督
私画停车线影响出行	秩序混乱
物业私自停水电/保密	管理简单粗暴
物业乱收费“12319热线来电”	管理费
嘉瑞通小区安装充电桩无法安装电表	申请与使用
居民居住房屋污水没有得到良好的处理	日常服务不到位
西城区和丰台区不交接导致无法成立业主委员会	组织、推选
物业不出租地下停车位导致居民无处停车	场地紧张
物业收费不合理	物业费
物业收费不合理	管理费
宣祥家园小区物业公司不作为#微博私信# 	质量和水平
镇政府迟迟未审批小区成立业委会问题	组织、推选
外面车辆随意出入小区问题	日常服务不到位
希望大兴区建委核实香海园物业申请公维基金应急流程及造价是否合理	申请与使用
车辆被砸伤后赔偿问题	安全没保障
尽快开启龙岗安居里小区的中央空调的冷风	日常服务不到位
投诉保安态度恶劣	日常服务不到位
物业未经所有业主同意实施租凭固定车位不合理	管理简单粗暴
希望相关部门核实调查了解小区情况	权力运作及监督
物业工作不负责任	态度与规范
无法成立业委会	组织、推选
希望了解物业是否有权利锁业主的车辆	保安不当行为
对本中心工作流程的建议	质量和水平
车位前方有障碍物影响出行问题	安全没保障
换门禁卡不合理问题/保密	质量和水平
出租屋有隔断	安全没保障
反映写字楼内存在安全隐患问题	安全秩序没保障
收费合理不合理	收费不合理
物业费收费标准不合理问题	物业费
慧泽园小区停车费收费过高不合理的问题	收费不合理
无法更换停车证	态度与规范
开发商迟迟不做对接的问题	日常服务不到位
物业涨百分之三十的物业费不合理问题	物业费
物业强迫收取停车费问题	管理简单粗暴
小区迟迟无法成立业委会	组织、推选
物业收取停车费未征求业主同意	收费不合理
尽快改选专家国际花园小区业委会	组织、推选
物业不给盖章无法安装充电桩	质量和水平
希望给停车位设置一个坡度	安全没保障
晨月园小区7号楼垃圾清理的问题	垃圾清运费
帮助规范电动车自行车停车充电问题	秩序混乱
楼道内放共享单车无人管	秩序混乱
单元门门禁故障无人处理的问题	安全秩序没保障
收费	管理费
未领到丧葬费	权力运作及监督
小区不让别的运营商进入	管理简单粗暴
居委会不让成立业主委员会问题	组织、推选
协调物业更换亮点的灯泡	入户维修态度及质量差
物业乱收费的问题	垃圾清运费
小区部分居民无法显示住房公共维修基金问题	缴纳与监管
物业不作为	质量和水平
物业管理不善导致小区频发盗窃事件	安全秩序没保障
万达物业门头费	管理费
投诉自家漏水物业不给解决物业不作为问题	质量和水平
物业收取房费差价不合理的的问题	管理费
物业收费不合理的问题	垃圾清运费
小区没有监控设施	监控实施损坏
物业收取服务费，业主对此意见大	管理费
小区不让外地车牌进入小区停车	场地紧张
举报村委会填埋生活垃圾	垃圾清运费
供暖费无人报销	自供暖社区供暖费
楼道和应急通道的灯都不亮	安全秩序没保障
物业强制补缴物业费不合理	物业费
保安不值班	保安不当行为
小区物业乱收费	管理费
咨询如何信息公开问题	权力运作及监督
佳运园社区工作人员态度恶劣	威胁恐吓业主
宝隆公寓小区楼道间停放大量电动车存在安全隐患问题	安全秩序没保障
小区物业日常服务不到位	日常服务不到位
强行推行人脸识别进门	质量和水平
物业收取水电费不合理	质量和水平
物业开据发票的规定不合理	入户维修态度及质量差
在居民楼开宠物医院不认可问题	管理简单粗暴
小区尽快进行老旧小区改造	质量和水平
希望小区物业对外来车辆停放加强管理	质量和水平
翠城盛园小区收取公共区域停车费问题	收费不合理
看车工作人员不履行职责	保安不当行为
希望加强管理东四十一条31号院外来车辆随意进入问题#微博私信#	秩序混乱
反映保安无辜推自己	保安不当行为
希望找到打自己的三个保安人员	保安不当行为
居委会开通道路导致小区停车秩序差问题	安全没保障
希望增设摄像头	监控实施损坏
在一层楼道不安装摄像头不合理	日常服务不到位
公共区域自来水水管损坏 物业一直维修不合理	物业费
小区内人员混杂安全不保障	安全秩序没保障
建议物业在小区单元门公告栏上张贴物业服务范围及标准#评论#	态度与规范
市民反映小区物业收费不合理的问题	管理费
星光大中心不退维修基金费用	缴纳与监管
黑保安不让进村	保安不当行为
38号楼天然气管道附近环境脏乱差	安全没保障
物业私自在小区电梯内安装广告	申请与使用
投诉物业不作为	质量和水平
北门被封死的问题	安全秩序没保障
物业楼门口结冰未及时清理	日常服务不到位
强制断水电问题	威胁恐吓业主
监控不亮	监控实施损坏
小区业委会非法成立希望重新选举问题	权力运作及监督
景一社区监控坏了	监控实施损坏
希望安装摄像头	监控实施损坏
摄像头损坏	监控实施损坏
希望撤除小区门口蔬菜直通车问题	权力运作及监督
物业迟迟不退装修保证金问题	缴纳与监管
停车秩序差	秩序混乱
物业乱作为问题	态度与规范
小区安全没保障问题	安全秩序没保障
希望成立居委会	日常服务不到位
小区物业管理不作为	秩序混乱
物业保安不当行为的问题	保安不当行为
保安服务态度太差	保安不当行为
物业收费问题	管理费
小区临时水电的问题	物业费
私占车位影响停车	秩序混乱
物业收加开门禁钱不合理	质量和水平
摄像头故障无人维修	监控实施损坏
希望建外街道办事处召开业主大会罢免业委会	权力运作及监督
向阳3号楼楼下的工作人员休息室被侵占	日常服务不到位
拆除地锁不合理问题	秩序混乱
未经业主同意，物业私自终止并转让小区物业服务，居民对此意见大	态度与规范
违法入驻	管理简单粗暴
未及时打扫小区内卫生	日常服务不到位
小区停车管理混乱的问题	秩序混乱
沿海赛洛城单元门门禁无人维修	安全秩序没保障
反映计算投票方式不合理问题	组织、推选
物业收取停车费用不合理	管理费
投诉小区物业不作为	质量和水平
自行车车棚出租不合理/保密	安全没保障
久长花园小区38号楼北侧垒墙不合理	管理简单粗暴
白色车辆侵犯个人隐私	安全秩序没保障
延庆区川北小区西区监控实施损坏	监控实施损坏
警察看守影响居民生活的问题	质量和水平
物业不作为	秩序混乱
 停水停电问题	管理简单粗暴
天鑫家园小区物业收钱允许游商在小区经营的问题#微博私信#	态度与规范
小区内停车秩序混乱的问题	秩序混乱
小区物业不作为	态度与规范
物业拒收暖气费	管理简单粗暴
原业委会不撤出影响居民生活安全的问题	受破坏及法律权益保障
物业不作为	质量和水平
小区物业调整停车费未征求业主意见	收费不合理
建议收取停车管理费用	秩序混乱
物业不处理在停车地方安装摄像头问题	监控实施损坏
物业私装地锁导致停车秩序差，影响居民出行	秩序混乱
希望石景山区农委尽快补缴公维基金问题	缴纳与监管
咨询业主委员会办理流程	组织、推选
物业不作为	质量和水平
保安收保护费	保安不当行为
物业不让进停车库	态度与规范
协调开通门禁	安全秩序没保障
物业不作为问题	态度与规范
物业乱收停车费，小区居民意见大	收费不合理
让外来车辆停在小区内存在安全隐患	安全没保障
瀛海家园小区保安给自己的车贴胶且态度恶劣“12316热线来电”	保安不当行为
路口北划车位线不合理影响通行问题	秩序混乱
停车秩序差	秩序混乱
清源佳园小区地下车位迟迟未开放使用	场地紧张
协调加强小区自行车停放管理	日常服务不到位
小区物业给小区固定停车位安装地锁不合理	管理简单粗暴
小区路灯关闭较早	入户维修态度及质量差
个关于停车费合理的解释	收费不合理
物业收费不合理	自供暖社区供暖费
希望治理高空抛物存在安全隐患问题	日常服务不到位
物业收费不合理的问题	收费不合理
小区内建设幼儿园不合理	安全秩序没保障
交身份证办理门禁卡不合理	管理简单粗暴
未按规定进行业务会选举/保密	组织、推选
无法成立业主委员会	组织、推选
出租公房不合理	日常服务不到位
业委会改选乡政府不给备案	受破坏及法律权益保障
楼上往下扔东西存在安全隐患问题	安全秩序没保障
物业违规收取装修保证金	物业费
物业费	物业费
物业收水电费不合理	自供暖社区供暖费
小区内业委会迟迟无法成立	组织、推选
协调重新选举成立业委会	组织、推选
小吃城排烟	态度与规范
电表走字异常	物业费
回迁房物业费太高	物业费
希望清理马蜂窝的问题	态度与规范
物业费收取不合理	物业费
物业不清理垃圾	日常服务不到位
小区物业管理不当问题	态度与规范
医院保安管理差	保安不当行为
物业管理不当	管理简单粗暴
物业不让行人通行的问题	态度与规范
物业堵死窗户/保密	日常服务不到位
柯建新等业委会人员冒签业主房屋维修基金调出业主的房屋维修基金问题	权力运作及监督
房地产开发经营公司有没有交公共维修基金	缴纳与监管
希望安装摄像头	监控实施损坏
希望帮助核实收取费用是否合理	管理费
不希望撤销怡萍小区业主委员会为	受破坏及法律权益保障
无法申请大修基金	申请与使用
物业不作为不给处理车库堵车问题	秩序混乱
装修保证金费用高不合理及收每平米10元钱的清理垃圾费不合理及物业推荐装修公司不合理	垃圾清运费
希望及时修理监控设施	监控实施损坏
物业私自涨价物业费，业主对此意见大	物业费
燃气报警器响被物业直接拔掉	管理简单粗暴
开元盛世物业不作为	申请与使用
成立业主委员会问题	组织、推选
小区内的门禁坏了	监控实施损坏
小区内乱停车，希望维护停车秩序	秩序混乱
邑上原著物业迟迟不给换玻璃	日常服务不到位
龙湖滟澜居委会协调物业对小区内人防车位等公共收益进行公示和审计	权力运作及监督
物业不作为	态度与规范
地下车库只有两个公共门存在消防隐患	安全没保障
地下室有安全隐患	安全秩序没保障
地下停车场被黑物业霸占。	秩序混乱
投诉物业不作为	日常服务不到位
彩虹家园北区10号楼3单元没有摄像头的问题	监控实施损坏
活动房占据停车位	安全没保障
投诉居委会态度恶略	态度与规范
僵尸车问题	安全没保障
加强对物业公司的管理的问题	权力运作及监督
百万庄小区长时间未使用摄像系统问题	监控实施损坏
 小区管理混乱	态度与规范
迎喜家园小区业委会成立要求不合理问题	组织、推选
投诉物业公司乱收费	自供暖社区供暖费
东家园小区物业不叫自家装空调	管理简单粗暴
小区内摄像头一直关闭	监控实施损坏
将台乡没有通过业主同意安装广告牌	受破坏及法律权益保障
外来人员随意进入小区，希望物业加强管理	安全秩序没保障
物业收取能源费不合理问题	自供暖社区供暖费
物业管理不到位	保安不当行为
投诉友谊家园小区物业	安全秩序没保障
希望小区成立新的业委会	权力运作及监督
物业动用公共维修基金问题#微博#	申请与使用
希望安装无障碍设施	安全秩序没保障
投诉物业人员	保安不当行为
伪造业主签名挪用维修基金	申请与使用
安装摄像头不合理问题	监控实施损坏
物业涨价	物业费
物业私自设立停车场对外经营的问题”12319热线来电“	态度与规范
夏各庄新城西区太阳能无法使用的问题	质量和水平
物业没有分配车位	秩序混乱
市民反映投诉物业服务态度差的问题	入户维修态度及质量差
物业私占公共场合	态度与规范
百环家园小区内建立电动车存车处并带有充电桩的停车位	安全没保障
停车费收费不合理的问题	物业费
车子占用道路	秩序混乱
希望增设监控设施	监控实施损坏
希望督促物业尽快公示工程进展照片#微博私信#	工作效率低
小区管理混乱问题	安全秩序没保障
投诉保安态度恶劣	保安不当行为
物业在幼儿园门口划停车位不合理	安全没保障
物业不作为	秩序混乱
选举业委会拉票不合理	权力运作及监督
马坊居委会工作人员偷拍自己	态度与规范
协调物业出具物业费涨价业主确认签字书问题	物业费
希望协调小区成立业委会	组织、推选
楼梯门口进水找不到物业管理人员	入户维修态度及质量差
门禁维修问题	入户维修态度及质量差
我爱我家青年汇店中介服务态度恶劣问题	态度与规范
楼道卫生差	垃圾清运费
电梯维保价高	缴纳与监管
小区内推选、成立业委会问题	组织、推选
物业不让自己装修问题	管理简单粗暴
交了停车费后没有地方停车	安全没保障
开发商将已经卖给自己的地库再重新卖给别人不合理	安全没保障
业主委员会不尽责	权力运作及监督
楼道灯不亮未及时处理	日常服务不到位
物业乱收费问题	垃圾清运费
门口安装装饰木条影响出行的问题	态度与规范
大厦内周末不开空调问题	管理简单粗暴
投诉物业乱作为 	质量和水平
地下停车场与商业街通道门位置不合理/保密	安全没保障
反映物业不作为“12369热线来电”	质量和水平
希望尽快把座椅拆除	质量和水平
投诉小区物业/保密	日常服务不到位
物业费收取不合理	物业费
希望超市重新开门	日常服务不到位
收取物业费不合理的问题	物业费
白广路43号楼东门被锁不合理的问题	安全秩序没保障
物业服务管理不到位	质量和水平
未公示结果引进停车公司收停车费不合理	安全没保障
投诉物业保安宋雪峰态度差	态度与规范
物业对停车管理不严	安全秩序没保障
希望相关部门协调安装监控	监控实施损坏
小区内经营饭店不合理	安全没保障
物业不让快递进小区不合理	质量和水平
停车秩序差	秩序混乱
开发商的前期物业霸占小区值班室不走	质量和水平
处理居住噪音扰民的问题/保密	安全秩序没保障
业主委员会强制让市民交钱问题	威胁恐吓业主
保安把门关闭	保安不当行为
物业态度恶劣	态度与规范
老年代步车占车位，影响他人停车	管理简单粗暴
私拉电线的问题	安全秩序没保障
居委会监控管理使用不到位	监控实施损坏
物业收费不合理	物业费
物业不作为	质量和水平
供暖公司不让停暖	自供暖社区供暖费
更换门禁不合理	态度与规范
私拉电线给电动车充电问题	日常服务不到位
物业不给自己姐姐办固定停车位不合理	质量和水平
小区物业工作人员态度恶劣，希望尽快处理	态度与规范
小区居委会不作为	权力运作及监督
开发商不给退公维费	申请与使用
小区保安恶意收费问题	保安不当行为
小区保安态度不好要开除	保安不当行为
物业收取管理费不合理的问题	管理费
希望清除物业帮助推选更规范的物业对纳帕溪谷小区进行管理/保密	组织、推选
工体北里故宫宿舍内私占车位【北京市委书记蔡奇】#人民网地方领导留言板#	秩序混乱
施工被物业断电	管理简单粗暴
希望尽快成立居委会	安全秩序没保障
外来车辆停车秩序混乱无人治理	秩序混乱
小区物业不管停车位被占问题	质量和水平
落实停车位	秩序混乱
街道不允许拆除遮阳棚不合理的问题	申请与使用
物业修缮的工作不合理	质量和水平
泰华滨河苑小区物业不给送电	入户维修态度及质量差
物业不作为	安全秩序没保障
投诉物业威胁恐吓业主/保密	威胁恐吓业主
推选北京市榜样存在不合理问题	组织、推选
希望解决占车位问题	场地紧张
北苑街道金源泉小区物业违法使用自来水进行绿化灌溉	权力运作及监督
物业不作为	日常服务不到位
小区地下车库无人管理的问题	秩序混乱
大兴区清源街道首邑溪谷小区12号楼2单元电梯坏了一个月，物业不处理	入户维修态度及质量差
物业工作方法不合理的问题	管理简单粗暴
物业中控设施不起作用问题	监控实施损坏
不让成立业委会不合理	组织、推选
小区楼道垃圾无人清理	日常服务不到位
小区内多处监控故障问题	监控实施损坏
对大型犬看管不利存在安全隐患	安全秩序没保障
自动门损坏需要维修	质量和水平
小区物业	态度与规范
希望在墙上开二个门方便大家出行	管理简单粗暴
业委会未经业主同意更换物业问题	权力运作及监督
核实收取垃圾清运费是否合理	垃圾清运费
罢免欠物业费的业委会成员问题	受破坏及法律权益保障
小区不让快递车进小区不合理问题	日常服务不到位
开发商收取商业用房的公共维修基金	缴纳与监管
物业乱收费问题	物业费
小区大门门禁未启用，导致外来人员随意进出，希望尽快启用	申请与使用
村委会没有资质收取停车费，希望查处	管理费
协调相关部门解决开发商不退费	缴纳与监管
居委会变向阻止成立业主委员会	组织、推选
八角北路社区36号楼3单元6层楼顶安装基站不合理#微博#	质量和水平
在物业买不上电字的问题	质量和水平
投诉三元家业不履行职责	管理简单粗暴
首邑溪谷小区绿地被破坏建停车场#微博#	态度与规范
无法安装充电桩问题	日常服务不到位
物业工作人员不在无法开供暖补贴的条的问题	物业费
希望更换小区物业	质量和水平
供电商赔偿	受破坏及法律权益保障
小区绿地建停车场不合理	质量和水平
督促开发商尽快签字盖章	组织、推选
物业私自动用维修基金	管理费
居委会大厅安装摄像头不合理的问题	监控实施损坏
门禁损坏没人处理的问题	监控实施损坏
物业收费不合理	垃圾清运费
小区停车收费标准不一致，居民对此意见大“12315热线来电”	收费不合理
物业收费不合理	管理费
保安服务态度极其野蛮	保安不当行为
希望物业尽快维修维修自家门铃	入户维修态度及质量差
物业退押金	自供暖社区供暖费
停车收费无资质	安全没保障
电动自行车和电动三轮车不按规定停放	秩序混乱
小区管理差“65603424热线来电”	安全秩序没保障
碧桐园小区成立业委会受阻	组织、推选
莱圳家园小区业主管理的公共收益资金一直被物业非法侵占#APP#	组织、推选
要求居委会退还停车费的问题	收费不合理
物业上班时间不合理，导致业主无法正常买电，希望调节物业工作时间	工作效率低
诉求不明#微博#	保安不当行为
公共地下车库没有信号存在安全隐患	安全没保障
房屋被泡物业不负责问题	日常服务不到位
小区卫生保洁不到位，门禁损坏无人维修，希望物业规范管理	态度与规范
不让晒被子不合理	权力运作及监督
收取临时停车费是否合理	管理费
什么部门能给自己开证明安装充电桩问题	管理简单粗暴
解决退还维修资金问题	缴纳与监管
投诉物业管理简单粗暴问题	管理简单粗暴
物业不公示物业费使用状况	物业费
市场调节价没有公开公示的问题	管理费
苇子坑甲1号院楼道环境脏乱差#微博#	质量和水平
收废品人员管理	态度与规范
物业私自将公共服务会所改变成办公用地，业主对此意见大	管理简单粗暴
物业管理问题	权力运作及监督
物业设立拦车杆不合理	收费不合理
投诉物业没有监控	监控实施损坏
楼道内充电动车存在安全隐患	安全没保障
定陵机场经理耍弄自己	态度与规范
清理车辆不合理	质量和水平
希望物业可以把2019以前物业支出明细公布出来	物业费
收取停车费不合理	收费不合理
盖房不合理的问题	态度与规范
物业费涨价不合理问题重	物业费
咨询垃圾处理费收费标准	垃圾清运费
停车场工作人员违规指挥车辆造成安全隐患	秩序混乱
物业不退押金	垃圾清运费
物业日常服务不到位	日常服务不到位
停车位问题	秩序混乱
收费不合理	垃圾清运费
恒大名都小区安装充电桩	入户维修态度及质量差
物业管理不善	自供暖社区供暖费
保安不让进门	保安不当行为
物业不处理摄像头损坏	监控实施损坏
物业乱收费	管理费
物业收取供暖费过高，业主对此意见大	自供暖社区供暖费
鸿坤理想城礼小区保安不让进小区	保安不当行为
上调物业费不合理问题	物业费
街道不帮助业主成立业主委员会问题	组织、推选
投诉保安部服务态度差	保安不当行为
永乐园三里2号楼单元门禁损坏问题#今日头条私信#	安全秩序没保障
无居委会	组织、推选
物业乱收停车费，小区居民意见大	安全没保障
保安人员态恶略问题	保安不当行为
自己小区开发商挖地下车库存在危险	安全没保障
博大新物业收取门禁卡费用不合理	管理费
乱停车问题#微博#	秩序混乱
小区内单元门损坏希望尽快修理的问题	申请与使用
楼上住户封住自家出气口的问题	日常服务不到位
物业工作效率低	入户维修态度及质量差
小区环境卫生差	日常服务不到位
车辆停放在小区内无法取出	安全没保障
电梯内摄像头无人维修的问题	监控实施损坏
玻璃破损无人处理 	安全没保障
核实施工方信息	质量和水平
 物业公司工作人员态度恶劣	威胁恐吓业主
小区立体车库升降设备故障，影响居民正常停车	安全没保障
北京交警app无法办理进京证问	申请与使用
上锁问题	日常服务不到位
小区监控损坏，中商和旭物业未及时维修	管理简单粗暴
希望对八角北路小区内实施停车管理的问题【北京市委书记蔡奇】#领导留言板#	秩序混乱
未退还公共维修基金费用	缴纳与监管
购买的车位没有产权证	安全没保障
不给开采暖证明不合理	自供暖社区供暖费
电线裸露问题	安全秩序没保障
希望海开房地产开发商移交小区停车库	安全没保障
居委会监控管理使用不到位	监控实施损坏
协调增设电瓶车棚问题	安全没保障
物业砍树不合理问题	管理简单粗暴
希望维修小区单元门的问题	管理简单粗暴
楼门禁故障问题	安全秩序没保障
珠江国际城八区使用维修基金不合理问题	缴纳与监管
物业私自把车拖走	管理简单粗暴
停车秩序混乱#微博私信#	秩序混乱
协调解决小区停车问题#微博#	秩序混乱
物业费高	物业费
投诉物业监管不利	态度与规范
物业不给及时维修水闸	日常服务不到位
地坛北里11号楼楼没有安装摄像头	安全没保障
物业乱收费	物业费
希望尽快停止改造停车场的行为	收费不合理
投诉燕京都物业不作为	质量和水平
消防门安全隐患	安全秩序没保障
建议政府给小区门口安装一个摄像头	监控实施损坏
物业不作为问题	安全秩序没保障
协调退费@消费纠纷	收费不合理
监控损坏无人维修	监控实施损坏
纳帕溪谷小区物业私设路卡不让通行	安全秩序没保障
核实物业收取装修监管费是否合理	管理费
梅园小区环境脏乱差问题	日常服务不到位
物业出租地下室居住经营	保安不当行为
东城区朝阳门内大街79号院停车秩序混乱	秩序混乱
物业收取业主门禁卡费用，业主对此意见大	管理费
手机质量差	入户维修态度及质量差
小区保洁不履行职责	态度与规范
物业设置固定停车位导致停车难	管理简单粗暴
希望合理增设监控探头	监控实施损坏
居民私自在楼道安装摄像头不合理	监控实施损坏
物业不申请公共维修基金修理墙渗水问题	申请与使用
物业不作为的问题	日常服务不到位
车辆被刮问题	安全没保障
地下车库出入口被封死不合理问题	安全没保障
核实停车场产权单位	安全没保障
物业收取供暖费时间较早问题	自供暖社区供暖费
小区物业不作为	日常服务不到位
小康家园5号楼-8号楼的休闲中心设置不合理	日常服务不到位
物业让租户交押金不合理	垃圾清运费
古桥物业公司公示支出明细费用的问题	缴纳与监管
希望物业加强对美然动力街区环境卫生管理	质量和水平
 反映物业不作为	管理费
珠江绿洲家园小区11号楼地下室使用明火做饭	保安不当行为
小区内停车秩序差，希望加强管理	秩序混乱
物业工作质量低下	质量和水平
车在小区被剐蹭物业不做处理的问题	态度与规范
物业乱作为问题	管理简单粗暴
小区单元门坏了没人修的问题	安全秩序没保障
物业收取装修押金不合理	物业费
希望取消小区保安摆拍的问题	日常服务不到位
小区监控设施损坏	监控实施损坏
小区业委会制定规定不合理	权力运作及监督
单元楼门禁和照明灯损毁，希望及时维修	申请与使用
小区引水渠被下水道直排问题	工作效率低
协调更换摄像头位置问题	监控实施损坏
在进出单元门口钉了好多小柱子不合理问题	安全没保障
希望协调成立业主委员会	组织、推选
小区加强管理的问题	质量和水平
莱圳家园小区业主管理的公共收益资金一直被物业非法侵占#APP#	组织、推选
垃圾桶清理不及时散发异味，影响周边居民生活	日常服务不到位
车辆被刮蹭没人管	安全没保障
小区脏乱差问题	管理简单粗暴
消防安全通道不让使用的问题	安全秩序没保障
小区停车位购买	秩序混乱
居民私自在楼道安装摄像头，影响周边居民生活，希望拆除	监控实施损坏
物业不作为	申请与使用
小区内无物业管理	日常服务不到位
投诉物业安保人员态度恶劣问题	保安不当行为
了解收取装修管理费何装修垃圾清运费是否合理	垃圾清运费
绿岛苑小区收支账务未公示	缴纳与监管
停车比较难，建议建设停车位	秩序混乱
小区环境脏乱差、绿地无人管理、地下车库迟迟未开放，影响居民生活，希望加强管理	质量和水平
投诉物业不作为	日常服务不到位
投诉物业管理不到位	态度与规范
物业不给自家车位不合理问题“12319热线来电”	态度与规范
楼道没有监控设备问题	安全秩序没保障
希望小区内共享单车加强管理在园区内不要骑行共享单车	安全秩序没保障
物业服务质量差	质量和水平
希望装单元楼安全门	工作效率低
物业不治理在楼下散发小广告不合理问题	日常服务不到位
希望小区业委会	组织、推选
住院部制度不好	保安不当行为
小区内私占车位的问题“12319热线来电”	秩序混乱
自行车乱停乱放，堵塞残疾人通道	秩序混乱
保安人员态度恶劣	保安不当行为
投诉北京市城建开发商和北京城承物业不作为的问题#微博私信#	态度与规范
 物业让交不合理的供暖费	自供暖社区供暖费
协调物业在铸造村一区内加装充电桩	态度与规范
了解物业收取占地费是否合理	管理费
物业员工占用消防通道停车不合理问题	安全没保障
在窗跟底下安装充电桩不合理“12369热线来电”	管理简单粗暴
小区保安不让搬家车进入	保安不当行为
咨询房子长年不住有没有减免费用方面政策	物业费
西坝河北里21号楼物业管理不善#市政府门户网站互动交流平台#	管理简单粗暴
物业不作为的问题	态度与规范
物业未经业主同意私自收取停车费，居民对此意见大	收费不合理
小区乱收费	自供暖社区供暖费
小区没有业委会，希望尽快成立	组织、推选
缴纳停车费用没有停车位	秩序混乱
居委会滥用职权的问题	管理简单粗暴
物业不作为	管理简单粗暴
联通营业厅用电导致自己家窗户带电地板发热存在安全隐患	安全秩序没保障
物业没有提前告知车位属于消防通道不合理	安全没保障
知春东里小区停车管理公司不作为	安全没保障
停车场无人管理	秩序混乱
物业乱砍树的问题	管理简单粗暴
连兴街2号院中奥嘉园一期没有启用监控【北京市委书记蔡奇】#领导留言板#	监控实施损坏
希望东王庄居委会在楼道贴出提示牌以做警示	安全秩序没保障
保安不给开门禁问题“12315热线来电”	保安不当行为
小区增设摄像头问题	安全秩序没保障
希望尽快成立业委会问题	组织、推选
物业费过高问题	态度与规范
希望取消业委会	权力运作及监督
空调外挂机安装保护架不合理	安全秩序没保障
协调曙光里40号楼安装门禁的问题	申请与使用
小区加大门问题	安全没保障
物业收取供暖费不合理	自供暖社区供暖费
物业阻止自己投票不合理	组织、推选
了解物业强制收取垃圾清运费是否合理12315“热线来电”	物业费
物业强制施工把路给围起来造成业主无处走路	日常服务不到位
违章生产问题	管理简单粗暴
黑物业变相收取物业费	物业费
押金不退以及收费不合理	管理费
物业态度恶劣问题	管理简单粗暴
小区没有安装监控的问题	监控实施损坏
小区内随意堆放生活垃圾，影响居民通行“12369热线来电”	质量和水平
车位被占用无人处理	安全没保障
树木砸车后物业公司不给赔偿	安全秩序没保障
小区绿化带黄土裸露，影响居住环境，希望尽快恢复绿化	日常服务不到位
帮助协调在小区单元门前安装摄像头	监控实施损坏
黄瓜园社区居委会收费不合理	管理费
不清楚怎么申请新旧小区改装的申请经费。	申请与使用
当代城市家园业主大队投票弄虚作假	权力运作及监督
核查了金信海城公司的停车手续是否正规【北京市委书记蔡奇】#人民网地方领导留言板#	秩序混乱
团河行宫别墅业委会主任独断专行滥用职权	权力运作及监督
馨港庄园小区内的垃圾用无资质运输的车辆清运	安全秩序没保障
物业不采纳业主建议且态度恶劣	态度与规范
物业私自转卖小区地库，违规改造后高价出售	管理简单粗暴
小区乱，无人管理	安全秩序没保障
板桥新苑小区物业不作为	工作效率低
了解卫生费收费标准	垃圾清运费
北门行人通道过窄问题	态度与规范
物业收取乱扔废旧物押金不合理，居民对此意见大	垃圾清运费
物业不给安装充电桩	质量和水平
物业收费不合理的问题	管理费
协调双丰街道尽快帮助小区成立业委会	受破坏及法律权益保障
希望成立业委会加大小区物业管理	组织、推选
如何成立业主委员会	组织、推选
红线胡同监控故障无人处理	监控实施损坏
业委会换物业公司不合理	组织、推选
物业私自涨垃圾清运费不合理	垃圾清运费
物业收费不合理的问题	管理费
树木无人修剪扰民问题	态度与规范
物业私自提取维修基金问题	申请与使用
居委会拆除停车收费杆	安全没保障
物业不让装修商铺	日常服务不到位
小区停车不合理	秩序混乱
清河街道综治办保安队长占用私人位置	保安不当行为
希望核实处理旧马桶问题	态度与规范
北京市劳动人民文化宫东门保安态度不好	态度与规范
小区物业分配车位不合理/保密	质量和水平
业务人员工作问题	入户维修态度及质量差
希望将空调室外机排水管放在统一的排水管内	态度与规范
投诉居委会和筹备组不支持小区使用北京业主违背政府意愿	权力运作及监督
迟迟无法更换业委会“12320热线来电”	组织、推选
不明诉求	管理费
物业将水表锁在管道井内，导致查表时不方便”12319热线来电“	入户维修态度及质量差
公司接受黑户人员	保安不当行为
小区物业不给更换防盗门的问题	入户维修态度及质量差
希望协调取消小区固定停车位的问题	秩序混乱
业委会主任滥用职权问题	受破坏及法律权益保障
物业涉嫌暗箱操作	物业费
物业私自提高物业费不合理的问题	物业费
张烨、邵兵兵不符合选举规定参加选举问题	组织、推选
门禁损坏无人维修及僵尸车无人清理#今日头条评论#	监控实施损坏
建造停车楼没有审批手续问题	安全没保障
小区内给电动车充电不合理	质量和水平
探头故障无人维修	监控实施损坏
小区起名不合理问题	申请与使用
物业肆意断水断电	管理简单粗暴
维修小区监控	监控实施损坏
物业收取物业费不合理的问题	物业费
希望小区地下停车场尽快开放	质量和水平
物业乱收费问题	物业费
自家在2018年5到6月份之间装修的房子，装修押金交了2000元，装修完后迟迟不退押金	管理费
 投诉东与物业不作为问题	态度与规范
投诉海开房地产股份有限公司抢占物业值班室和配套用房	质量和水平
投诉小区车位管理部门的管理服务差	安全没保障
停车场洗车的和修车的挡路导致无法正常停车	秩序混乱
报箱没有钥匙导致取不了报纸的问题	申请与使用
侵害到小区业主权益的问题	受破坏及法律权益保障
 物业不作为	态度与规范
单元门故障	监控实施损坏
多次申请成立业委会未成功	组织、推选
相关部门尽快帮助处理和平里街道办事处综合治理部门至今不给安装摄像头	安全秩序没保障
瑞源国际小区物业收取电费标准不合理问题	质量和水平
物业收费不合理	管理费
供暖收费不合理	物业费
物业做出的处罚不合理问题。	权力运作及监督
希望职能部门帮助处理成立业委会不公开透明	组织、推选
小区内停车秩序差	秩序混乱
投诉物业管理差问题	管理简单粗暴
停车秩序乱	秩序混乱
业委会主任（科建新）	权力运作及监督
 物业不允许安装充电桩	申请与使用
投诉物业#评论#	态度与规范
小区不让使用惠民资金，业主意见大	申请与使用
物业使用公共维修基金不合理	申请与使用
加强清雅小区治安管理	监控实施损坏
希望小区尽快成立业委会	组织、推选
建议加装门禁	安全秩序没保障
办停车证要求四证不合理	秩序混乱
物业不给处理保安不让自己出去的问题	保安不当行为
物业禁止搬家货车进入小区，居民对此意见大	保安不当行为
物业收费不合理	管理费
物业不给激活门禁卡	管理简单粗暴
希望治理外来车辆进小区	日常服务不到位
天通苑东三区16号楼前没有摄像头	监控实施损坏
物业态度恶劣/保密	态度与规范
业主积极要求成立业委会申请受到各方面阻力问题。	组织、推选
自家停电未进行提前通知，业主对此意见大	态度与规范
物业费收费不合理的问题	物业费
小区内多处监控故障问题	监控实施损坏
楼长违规收费	管理费
物业没有供暖资质收取供暖费	自供暖社区供暖费
协调加强小区治安管理	安全秩序没保障
风雅园二区居委会效率低下	权力运作及监督
停车场不退停车费的问题	安全没保障
商家恐吓市民	威胁恐吓业主
出租房屋导致周边环境差	安全秩序没保障
莱圳家园小区业主管理的公共收益资金一直被物业非法侵占#APP#	组织、推选
协调街道尽快给业委会备案问题	权力运作及监督
核实小区如何申请公共维修基金	申请与使用
小区内多处监控故障	监控实施损坏
道路阻塞不方便通行	日常服务不到位
投诉物业乱收装修清运费	垃圾清运费
物业不作为	日常服务不到位
物业管理不到位	保安不当行为
希望尽快帮助引进物业	安全秩序没保障
投诉7号楼夜班值班保安监守自盗问题	保安不当行为
小区物业收取小区业主出入费不合理	管理费
小区没有业委会，希望尽快成立	组织、推选
协调解决车库杆经常坏的问题	质量和水平
韦博豪家园业委会不作为扰乱小区秩序	权力运作及监督
龙兴园北区总招贼导致业主人心惶惶	安全秩序没保障
非法使用公共维修基金	缴纳与监管
远悦物业公司不作为的问题	入户维修态度及质量差
赔偿问题	监控实施损坏
西井路17号1号楼5层516室	物业费
SOHO12号楼保安不当行为	保安不当行为
  北燃热力不作为	态度与规范
投诉国家新闻出版广电总局播出质量监督投诉中心话务员	态度与规范
停车管理收费过高不合理	收费不合理
单元门门禁无法使用	日常服务不到位
小区治安不完善问题	安全没保障
投诉物业管理失误	管理简单粗暴
监控损坏问题	监控实施损坏
14门出口被车堵了门口不方便居民出行	安全秩序没保障
反映投诉美的物业	入户维修态度及质量差
物业动用大量维修基金进行修缮是否报区里审批	申请与使用
小区物业占用小区小广场建设停车场不合理	安全没保障
颐和山庄小区停车乱收费“12315热线来电”	收费不合理
希望物业退还自己装修费押金的问题	态度与规范
物业不开地库门问题	态度与规范
小区物业禁止电信安装宽带的问题	管理简单粗暴
小区没有监控	日常服务不到位
建议把地下停车出口改进到小区外	秩序混乱
楼道灯损坏无人维修，小区饮用水有异味，同心龙旺庄物业不负责	日常服务不到位
小区无人管理环境	日常服务不到位
高力物业不让装充电桩不合理	态度与规范
物业威胁恐吓业主	威胁恐吓业主
水站占用公共空间	态度与规范
投诉华润置地开发商不作为/保密	态度与规范
协调清理面包车	秩序混乱
小区业委会迟迟不能成立	组织、推选
物业保安要求抵押行驶证驾驶证不合理	保安不当行为
希望相关部门协助清理小区保安问题	保安不当行为
核实了解收取垃圾清运费是否合理	垃圾清运费
反映物业不作为	态度与规范
小区内乱停车	秩序混乱
物业为经业主同意私自上涨停车费，业主对此意见大	收费不合理
地下车库阻车栏杆故障，影响业主出入	日常服务不到位
物业收取停热水钱不合理问题	管理费
建围挡不合理	管理简单粗暴
建议在小区门口设置门禁	监控实施损坏
水表外阀门漏水问题	缴纳与监管
小区违建围栏问题	保安不当行为
 物业不作为问题	管理费
咨询垃圾清运费标准	垃圾清运费
有人恐吓骂自己的问题	威胁恐吓业主
尽快成立业主委员会	组织、推选
小区内堆放生活垃圾，希望清理	安全没保障
物业不作为	质量和水平
竞聘物业投票流程不合理，未向业主公示物业公司信息	组织、推选
物业乱收费的问题	物业费
小区车库住人	安全没保障
社区发布信中没有告知会议开始的时间地点	日常服务不到位
物业不给开具证明的问题	质量和水平
投诉祥和乐园物业违规收取供暖费的问题	自供暖社区供暖费
业委会信息	组织、推选
雁栖经济开发区管委会行政不作为	组织、推选
小区交通秩序混乱	秩序混乱
了解更换新物业的流程	管理简单粗暴
业委会无法改选问题	组织、推选
补开物业费和发票问题。	工作效率低
建议在215楼安装摄像头	监控实施损坏
要求记录	态度与规范
旧宫西里小区尽快对围挡位置进行修复	日常服务不到位
物业乱收费问题	管理费
物业供暖收费不合理的问题	自供暖社区供暖费
多建几个车位	申请与使用
开发商造假出售车位批文	管理简单粗暴
公布管理服务费收支情况	入户维修态度及质量差
物业交电费时间不合理	管理费
咨询小区建筑垃圾清运政策	垃圾清运费
开发商地下车库车位随意涨价不合理	收费不合理
建议小区加设电子感应杆避免外部车辆进入小区停车	秩序混乱
不认可保安的处理方式	保安不当行为
收费不合理	管理简单粗暴
地下室开培训班不合理	日常服务不到位
小区内停车秩序差	秩序混乱
物业乱收费问题	管理费
希望在小区楼道增设摄像头	监控实施损坏
物业强制收取清运垃圾钱不合理	垃圾清运费
未经业主同意，物业私自领取公共维修基金	申请与使用
车在车位被砸无人管理的问题【北京市委书记蔡奇】#领导留言板#	安全秩序没保障
物业不处理住户家返水的问题	质量和水平
南海家园六里物业贴的通知无法铲除问题	管理简单粗暴
砍小区树木不合理	管理简单粗暴
希望尽快维修8号楼2单元扶手	安全没保障
物业费收取供暖费不合理	自供暖社区供暖费
希望小区大门增设车辆进出杆	秩序混乱
市民投诉物业不负责问题	态度与规范
小区监控损坏无人维修导致业主车辆受损	日常服务不到位
小区监控摄像头损坏问题	监控实施损坏
小区监控室无人值守，希望物业规范管理	管理简单粗暴
迟迟未安装监控问题	监控实施损坏
物业管理	安全秩序没保障
海淀街道不给小区备案业委会	组织、推选
小区内乱停车	秩序混乱
收取燃气管道进户费用不合理	自供暖社区供暖费
亮马家园36号楼5单元31号和32号物业停电	态度与规范
物业不管门禁开放的问题	安全秩序没保障
门禁未安装开锁设施问题	安全秩序没保障
物业收费不合理”12385热线来电“	管理费
徳佳物业私自挪用公共维修基金	申请与使用
乱停车堵路	秩序混乱
左家庄街道不作为的问题	态度与规范
希望尽快加固天窗盖子	安全秩序没保障
希望及时修理监控设施	监控实施损坏
物业没收自己东西不合理	日常服务不到位
小区高压线损坏，导致烧坏居民家电器，希望解决	安全秩序没保障
小区内物业不通电的	监控实施损坏
申请使用专项维修资金维护顶层滴漏	申请与使用
停车收费高的问题	管理费
物业管理不规范问题	安全没保障
小区保安不让快递车出小区，导致快递员无法回家	保安不当行为
珠江逸景小区物业使用公共维修基金	申请与使用
撤销调将车停在黄村西里小区内	秩序混乱
协调物业把30号楼楼前自行车码放整齐	秩序混乱
小区内僵尸车清理不及时，影响居民通行	秩序混乱
希望增设停车棚	安全没保障
地下停车场与商业街通道门位置不合理	安全没保障
希望清理小区内垃圾	态度与规范
华杰大厦物业态度恶劣	态度与规范
有人使用健身器材晾晒被单，影响其他居民活动	质量和水平
干示消防栓内的水怎么放出问题	安全秩序没保障
业委会候选人赵先生无资格当候选人问题	组织、推选
投诉物业绿化规划不合理	权力运作及监督
物业办理门禁卡采集信息之后将门锁上不合理	管理简单粗暴
物业没有维修监控问题	监控实施损坏
建议在楼道内增设摄像头	监控实施损坏
物业管理公司没有做好相关登记工作导致车辆重复收费	秩序混乱
宣武医院门口保安将自己和丈夫挡在门口的问题	保安不当行为
小区门禁卡不完善问题	日常服务不到位
私装摄像头	监控实施损坏
反映物业未将物业费使用进行公示不合理	物业费
占用消防通道停放车辆，希望及时清理	秩序混乱
小区的物业装修垃圾收取费用不合理	垃圾清运费
小区无人管理导致小区胡乱停车问题	秩序混乱
希望在小区门口安装栏杆	安全没保障
投诉物业绿化规划不合理	权力运作及监督
物业不配合安装充电桩问题	日常服务不到位
交物业费不合理	物业费
加强管理小区大型车以及社会车辆的问题	秩序混乱
反映业委会组织更换物业不合理的问题	权力运作及监督
希望取消固定停车位	秩序混乱
物业收费不合理	管理费
伪造业主签名挪用维修基金	申请与使用
物业不合理动用小区公共维修基金	缴纳与监管
协调引进物业管理定福庄西街小区卫生和安全问题【北京市委书记蔡奇】#人民网地方领导留言板#	组织、推选
建议小区物业管理人性化	日常服务不到位
物业不给处理保安不让自己出去	保安不当行为
山水文园东园A区物业现存问题#市政府门户网站互动交流平台#	管理简单粗暴
物业垃圾清理费过高	垃圾清运费
物业不给盖章无法安装电动汽车的电表	日常服务不到位
健身房消防不合格	安全秩序没保障
3单元安装摄像头	安全秩序没保障
 小区保安不给业主开门并辱骂市民	保安不当行为
物业乱收费	垃圾清运费
建设增设正规停车位	场地紧张
金九城物业威胁恐吓业主	威胁恐吓业主
居委会评定文明户不合理问题	权力运作及监督
收费不合理	物业费
国家电网中央商务区所不按照规定安装充电庄电表	安全秩序没保障
物业强制要求缴纳滞纳金不合理	物业费
北地下车库入口和地面北小区门关闭问题。	日常服务不到位
协调制止物业自私改供暖问题	管理简单粗暴
物业不作为及态度差问题	威胁恐吓业主
收取出租车司机停车费不合理的问题	收费不合理
物业收费不合理问题	物业费
小区没有监控	监控实施损坏
物业不服务态度差	入户维修态度及质量差
北郝庄家园居委会清理楼道杂物未公示问题	组织、推选
物业不让装电车	权力运作及监督
希望安装摄像头	监控实施损坏
小区未成立业委会，希望尽快组建	组织、推选
修理损坏的监控	质量和水平
小区保安不让邮政车辆进入问题	保安不当行为
物业私自使用公共维修基金做消防不合理	申请与使用
物业不作为问题	质量和水平
物业不作为问题	管理简单粗暴
物业随意增长停车费	收费不合理
小区物业私自开放停车场	管理简单粗暴
投诉物业不让开出租车的业主开车进小区问题/保密	管理简单粗暴
物业居委会联合执法强拆小区围栏没有安全保障	安全秩序没保障
小区立体车库升降设备故障，影响居民正常停车	安全没保障
小区居民不同意建居委会和社区服务站	权力运作及监督
物业拿铁管子把门堵着不让业主进去和出去不合理	威胁恐吓业主
物业乱收费的问题	管理费
在小区拉横幅不合理的问题	组织、推选
协调居委会修改方案	权力运作及监督
小区治安差	安全秩序没保障
物业乱收费问题	物业费
投诉物业#微博#	态度与规范
业委会消费不合理问题	权力运作及监督
建议物业治理不栓狗绳问题	质量和水平
保洁人员在小区内堆放废品导致小区环境脏乱差的问题	日常服务不到位
核实修复门禁问题	安全没保障
物业宽带价格过高且不让自己进行安装问题	管理费
街头游商问题	保安不当行为
物业私自动用公共维修基金维修房顶，业主对此意见大	管理费
物业雇佣年长保安不合理	保安不当行为
开发商以及物业违规装修且出租房屋	管理简单粗暴
业委会竞选报名时间过短不合理/保密	权力运作及监督
协调毛纺西小区物业不要随意拦截业主车辆进入小区	保安不当行为
电动汽车充电桩停电无法使用问题	安全没保障
门禁电话损坏需自费不合理	监控实施损坏
违规使用维修基金以及不公示	申请与使用
阻挠成立业委会	组织、推选
 人员聚集问题#微博私信#	态度与规范
投诉物业态度恶劣问题	管理简单粗暴
小区地下车库关停不合理	安全没保障
杨庄小区停车秩序管理混乱	秩序混乱
市民反映小区收停车费不合理问题	收费不合理
了解公共维修基金缴纳及管理	缴纳与监管
协调不让社会车辆进入小区	安全没保障
反映海淀区空军总院保安态度恶劣问题	保安不当行为
小区停车位混乱	场地紧张
成立业委会问题	组织、推选
小区停车无人管理	秩序混乱
小区私装地锁，影响居民停车#微博私信# 	态度与规范
街道物业乱作为	物业费
车辆在小区被刮，物业未做任何处理	安全没保障
物业乱收费的问题	物业费
物业收费不合理	垃圾清运费
地杰物业公司监控缺失	监控实施损坏
小区业委会不作为问题	权力运作及监督
小区没有人管理治安差问题	安全秩序没保障
安装摄像头问题	监控实施损坏
物业不作为给强制锁电梯	日常服务不到位
康景物业催缴收费行为恶劣	管理简单粗暴
治理小区乱停车现象	秩序混乱
反映希望协调有关部门尽快给小区更换监控摄像头全面覆盖小区	监控实施损坏
 龙门B2小区物业不作为	入户维修态度及质量差
小区物业强行收取垃圾清运费不合理	垃圾清运费
物业不让自己联系的工人进门	管理简单粗暴
协调清退卖卖桶装水的住户	日常服务不到位
单元门坏希望维修的问题	态度与规范
协调外包公司解决问题	安全秩序没保障
物业管理不到位	日常服务不到位
小区内车辆停放堵住门口	安全没保障
多收取生活垃圾费不合理的问题	垃圾清运费
业委会不作为	权力运作及监督
无法打印维修基金信息	申请与使用
未经业主同意，停车管理公司私涨停车费，并高价出售小区人防车位，居民对此意见大	物业费
居委会不处理小区消防通道被占用的问题。	权力运作及监督
小区物业收取垃圾清运费不合理	垃圾清运费
物业恶意停水	态度与规范
停暖后还收取供暖费不合理问题。=	自供暖社区供暖费
地下车库住人	安全没保障
南湖东园219号楼每层楼道墙皮发黑且贴满小广告问题	日常服务不到位
出租车骂人的问题	态度与规范
业委会涉嫌滥用小区维修基金的问题/保密	权力运作及监督
物业不通天然气问题	自供暖社区供暖费
物业私自外租老年活动室问题	质量和水平
房屋漏水后续工作物业不给自己处理	入户维修态度及质量差
物业服务态度差	入户维修态度及质量差
垃圾桶摆放不合理	质量和水平
建议玉树临风小区成立业委会问题	组织、推选
物业工作质量差的问题	物业费
小区环境治安	安全秩序没保障
开发商违规收取住房维修基金，希望查处	缴纳与监管
投诉物业不作为	态度与规范
核实规定以户为单位参加选举是否合理	组织、推选
不让自己进入小区的问题	威胁恐吓业主
投诉物业不作为	态度与规范
小区安装电梯迟迟未动工	权力运作及监督
要求物业公司停车费要合理公开	收费不合理
私家车占用消防通道停放，存在安全隐患	态度与规范
希望尽快安装摄像头	监控实施损坏
没有大门社会车辆及外来人员进入小区导致小区业主停车紧张问题	场地紧张
希望帮助核实排水管产权单位信息	安全秩序没保障
莱圳家园小区业主管理的公共收益资金一直被物业非法侵占#APP#	组织、推选
物业查表工作不到位导致多收自己水费	管理费
希望物业把小区地下车库出入口打开	安全没保障
希望拆除充电桩	秩序混乱
清河小营桥北莱圳家园北区正对西门位置车辆停在草地里#APP#	秩序混乱
楼下打洞自家阳台裂开问题	工作效率低
投诉保安无故不让进小区	保安不当行为
物业管理差问题	态度与规范
物业不作为	态度与规范
小区物业乱收费	收费不合理
小区管理问题	质量和水平
物业要求出示证件不合理的问题	物业费
物业不申请维修基金	质量和水平
安装防盗门不合理	日常服务不到位
物业私自拆除统一安装的车位锁	质量和水平
小区居委会迟迟未成立	组织、推选
热力集团赔偿金迟迟未到账	申请与使用
牛街一区物业不作为	日常服务不到位
小区不让进车问题	安全没保障
投诉北京东亚新华物业管理有限公司服务质量#微博#	管理简单粗暴
物业管理费过高	物业费
物业变相收费	管理费
小区停车秩序混乱	秩序混乱
物业强行断电私自将电表内的保险丝拿走	管理简单粗暴
物业乱收费的问题	物业费
监控设施无法正常使用	监控实施损坏
义宾南区内有外部车辆停车问题	秩序混乱
核实处理车位设置不合理的问题	安全没保障
农光南路5号楼门禁损坏#微博私信#	安全秩序没保障
政府迟迟不给小区业委会备案	组织、推选
地锁被撬问题	安全没保障
车辆无法正常出入	安全没保障
监控损坏无人处理	监控实施损坏
 物业损坏自己的载具	监控实施损坏
物业多收取物业费，业主对此意见大	物业费
物业使用公共维修基金维修房顶报价高，且未进行公示具体明细，业主对此意见大	申请与使用
小区内个人组织建立管委会乱收费的违法行为	管理费
小区内停车秩序差，希望规范管理/保密	秩序混乱
核实业主交电梯维修费是否合理	管理费
物业私自更改地下车库	秩序混乱
希望有关人员协调白秀玲出示健康证明	权力运作及监督
恋日绿岛小区黑恶势力问题	受破坏及法律权益保障
小区橱窗违法贴大字报问题	权力运作及监督
物业把多彩家园小区居民家电表箱锁起来不合理问题	质量和水平
小区治安不完善问题	安全没保障
小区物业动用公共维修基金不合理的问题	缴纳与监管
撤销反映	质量和水平
大型垃圾无处扔	垃圾清运费
供暖费用收取不合理	自供暖社区供暖费
希望本中心督促物业加装摄像头	监控实施损坏
自行车停车处被私自出租	秩序混乱
物业断电不合理	管理简单粗暴
在社区内增加监控问题	监控实施损坏
物业收取房费差价不合理的问题	管理费
投诉对物业服务态度及工作质量的不满	监控实施损坏
希望帮助核实房屋公共维修基金如何过户	申请与使用
物业出租人防工程的房子	入户维修态度及质量差
物业未经允把垃圾桶安在市民楼下	态度与规范
小区安全设施不完善	安全秩序没保障
小区不经业主同意装电梯刷卡	管理费
希望协调更换保安公司/保密	保安不当行为
小区楼道堆放垃圾	安全秩序没保障
协调物业退停车费	收费不合理
安立路28号上元雅园小区东门被商业非法占用的问题	秩序混乱
停车秩序混乱	秩序混乱
朝阳旺角小区电动车充电桩车棚下停车秩序差	日常服务不到位
反映防盗门纱窗坏了物业不管的问题	入户维修态度及质量差
小区内有不明人物	安全秩序没保障
丰台区建欣苑三里北小区有精神病患者堵在单元门口#网络诉求舆情#	安全秩序没保障
物业侵占消防通道建房出租，存在安全隐患，希望处理	质量和水平
小区内私装地锁现象严重，希望拆除	质量和水平
物业乱收费	自供暖社区供暖费
投诉物业管理粗暴	管理简单粗暴
市民反映物业私接水电问题	物业费
小区没有居委会问题	组织、推选
交取地下室维修费不合理	物业费
协调小区成立业委会和居委会管理问题	组织、推选
监控设施损坏无人管理	监控实施损坏
物业工作不到位导致居住安全无保障	安全秩序没保障
瑞海大厦物业强制清退问题。	管理简单粗暴
让业主承担费用不合理问题	管理费
北京像素南区行驶电动车的问题#微博#	质量和水平
申报专项	申请与使用
居委会主任不依法公开收支账目的问题	质量和水平
物业不作为的问题	质量和水平
停车管理秩序差	秩序混乱
物业没有通知业主	质量和水平
小区内配电间堆放杂物存在安全隐患	工作效率低
物业贴条没有进行告知义务不合理	质量和水平
石景山区苹果园街道西山枫林四区自行车棚不达标	安全秩序没保障
认为提前半年收取供暖费用不合理	缴纳与监管
北七家镇政府驳回业主代表申请不合理的问题	权力运作及监督
小区未安装车棚和未提供充电桩问题	工作效率低
垃圾清理费设置收费不合理问题	垃圾清运费
物业不作为	质量和水平
小区没有业委会，希望尽快成立	组织、推选
投票不合理问题	组织、推选
物业不负责	入户维修态度及质量差
监事会乱作为	权力运作及监督
业委会成员在小区楼下大厅拉横幅不合理	组织、推选
 龙湖滟澜居委会协调物业对小区内人防车位等公共收益进行公示和审计	权力运作及监督
反映楼道垃圾无人清理的问题	垃圾清运费
因物业不作为要求更换物业	管理简单粗暴
首开康乃馨小区物业不作为	日常服务不到位
要求业委会召开业主大会	权力运作及监督
小区设备不完善未收房	管理简单粗暴
龙锦苑东二区两天清理一次垃圾不合理问题	质量和水平
物业不给处理保安不让自己出去	保安不当行为
小区围墙砸到车没人赔偿	安全没保障
尽快组织成立业委会	组织、推选
一楼住户在阳台给电动车充电换电池容易发生安全隐患	安全秩序没保障
小区物业管理不规范	态度与规范
物业私自圈占公共区域出租问	质量和水平
楼道门禁损坏，希望尽快维修	日常服务不到位
小区物业服务质量差	入户维修态度及质量差
车辆停在小区里面被撞物业摄像头损坏不给处理	安全没保障
小区从2014年开始筹备成立业委会，因物业阻挠至今未成立，希望帮助解决	受破坏及法律权益保障
小区物业收费不合理	物业费
希望恢复治安探头	监控实施损坏
咨询小区什么时候入驻居委会	组织、推选
物业不作为的问题	管理简单粗暴
小区内的监控实施损坏无人修复	监控实施损坏
投诉小区中介不作为问题	质量和水平
物业不作为	态度与规范
电热板和卧室开关安装不合理问题	日常服务不到位
小区环境整治	入户维修态度及质量差
小区楼道内停放电动自行车充电存在安全隐患问题	安全没保障
中粮稻田雅筑自住型商品房物业乱收费问题#微博#	管理费
物业不作为问题	质量和水平
琉璃渠村物业私自收取200元的开锁费	管理费
大门不开放	日常服务不到位
 反映漏水无人修缮问题。	入户维修态度及质量差
小区围栏移动不合理	受破坏及法律权益保障
公司物业保安不让进门	保安不当行为
希望增设监控探头	监控实施损坏
使用人脸识别身份证绑定进小区不合理	管理简单粗暴
小区无社区居委会，导致居民办事困难，希望增设社区居委会	组织、推选
小区内停车乱收费，希望查处	收费不合理
小区物业收取清运费不合理	垃圾清运费
物业垄断不让到远洋国际楼上送快递	日常服务不到位
撤销物业让自己赔偿的问题	安全秩序没保障
曙光街道不让小区单独成立业委会	组织、推选
物业私自停水不合理	质量和水平
物业收费不合理	管理费
开发商未按承诺缴纳公共维修基金	缴纳与监管
希望三农洗车能到小区为居民洗车	申请与使用
小区物业锁小南门不合理问题	管理简单粗暴
物业迟迟不给修门禁	日常服务不到位
街道不让成立业委会	组织、推选
格兰山水二期南区摄像头不清晰	监控实施损坏
地库灯不亮问题	安全没保障
建议海淀区引领新科技更换清晰的摄像头	安全秩序没保障
未经业主同意，物业私换小区单元门	缴纳与监管
丰台区马家堡街道小区物业管理差的问题	安全没保障
小区内污水井返水，希望及时维修	日常服务不到位
电梯里小便无人管理	日常服务不到位
家委会强行收取卫生费不合理	垃圾清运费
核实是否有对华燕家园小区引进物业的计划#市政府门户网站互动交流平台#	组织、推选
小区内居民私自划车位	秩序混乱
协调区环保局空出自行车棚	安全没保障
业委会在外墙打窗户不合理	受破坏及法律权益保障
物业收费不合理	自供暖社区供暖费
未经业主同意私自引进新物业，业主对此意见大	权力运作及监督
街道不让成立业委会	组织、推选
希望帮助核实小区收垃圾的人向业主收垃圾费不合理	垃圾清运费
北宇物业推卸责任	入户维修态度及质量差
反映停车公司管理不擅问题	安全没保障
小区内门禁故障	安全秩序没保障
物业雇的保安不让进出小区	管理简单粗暴
小区没有监控导致车牌被拆问题	监控实施损坏
加强对楼道的清理	日常服务不到位
反对居委会入住小区	组织、推选
物业不作为	物业费
小区停车秩序差	管理费
希望儒林街道和月安居小区办尽快发放维修基金	申请与使用
要求把墙恢复原样并做防水问题/保密	安全秩序没保障
老楼改造电梯安装	申请与使用
来电反映物业不卖电问题”12315热线来电“	物业费
反映小区南门不开导致绕行的问题	态度与规范
车辆占用人行道违章停放问题	秩序混乱
希望小区加强管理不要让外人随意进入	保安不当行为
存在违规行为列入选举名单不合理	组织、推选
保安不让自己出监控室	保安不当行为
 物业收费不合理	物业费
物业私自出租公共停车位，导致业主无法停车	安全没保障
希望增加物业的问题	质量和水平
二七厂宿舍建设一里监控无红外导致夜间无法拍摄	监控实施损坏
反映物业不让加装护栏不合理	安全秩序没保障
自己车辆损坏由谁赔偿	安全没保障
小区安保不作为/保密	日常服务不到位
因物业拖欠垃圾清运费，导致小区内垃圾迟迟未清理，影响居民生活环境	垃圾清运费
物业收费不合理#评论#	自供暖社区供暖费
建议地下车库增设门禁和摄像头#今日头条评论#	日常服务不到位
投诉物业不给处理水池子堵塞问题	管理简单粗暴
房屋不符合依法治理违法群租房通告居委会强行拆除问题	质量和水平
协调调换停车位	质量和水平
希望招标正式物业	组织、推选
小区物业乱收费	自供暖社区供暖费
物业不给修自来水阀门的问题	日常服务不到位
小区内乱停车	秩序混乱
希望居委会周六日安排值班人员	权力运作及监督
 小区保安骂人、物业不处理的问题	保安不当行为
小区保安态度恶劣	保安不当行为
村里监控损坏无人维修	监控实施损坏
楼道内无监控不合理问题	监控实施损坏
希望物业加强小区停车管理问题	秩序混乱
搬家公司前后要价不同	监控实施损坏
物业不给自己开具装修证明的问题	垃圾清运费
社区没有通知到位导致业主分不到车位	权力运作及监督
小区的管理差	安全秩序没保障
不让进小区不合理	管理简单粗暴
投诉物业	管理简单粗暴
移走树木建设立体停车场不合理问题	质量和水平
解决车辆和行人同时从小区东门进出存在安全隐患	安全秩序没保障
停车管理差	安全没保障
物业在未公示收费审批的情况下忽然收费不合理	管理费
帮助协调让街道出示交物业费的凭证	物业费
物业收取物业费不合理	物业费
物业强拆	管理简单粗暴
小区内无监控设施，希望增设	监控实施损坏
物业公司不退装修押金	管理费
小区内多处监控故障	监控实施损坏
3号楼内1层监控故障	监控实施损坏
投诉小区路灯不给照明	日常服务不到位
小区业委会不作为	权力运作及监督
润景园小区物业不作为	态度与规范
小区私定供暖费	自供暖社区供暖费
街道利用小区设施牟且不管理小区	安全秩序没保障
小区门口停车乱无人管理	秩序混乱
北苑街道强行拆除小区内彩灯	管理简单粗暴
暖气费不合理涨价	自供暖社区供暖费
小区乱停车占消防通道问题#微博#	秩序混乱
业主家装修，装修公司负责清运垃圾，但物业强制收取垃圾清运费	垃圾清运费
小区垃圾无人处理	垃圾清运费
希望在门禁门内楼道内安装摄像头	安全秩序没保障
帮助清理垃圾堆	秩序混乱
小区监控长期不启用	监控实施损坏
物业触碰物权法	态度与规范
汽南小区25号楼3单元2号一老太太威胁影响自己人身安全	威胁恐吓业主
火灾安置问题	安全秩序没保障
占用消防通道规划停车位不合理，存在安全隐患	安全没保障
物业非法断电的问题	管理简单粗暴
协调物业费能降低的问题	物业费
核实到哪里看小区公共区域收益明细问题	权力运作及监督
不让快递进小区不合理	保安不当行为
玉泉新城小区业委会账目不公开	权力运作及监督
加装摄像头	监控实施损坏
了解物业收取维修费是否合理	物业费
日下防盗门厂服务态度问题	态度与规范
三元公司不给盖音量无法申请维修基金	申请与使用
希望增设监控	监控实施损坏
不给停车位	秩序混乱
希望帮助增设摄像头	监控实施损坏
复兴路46号院1号楼与3号楼楼顶住人	管理简单粗暴
物业强制消费问题	管理简单粗暴
西罗园小区四区31号楼蟑螂无人清理	日常服务不到位
物业不作为/保密	质量和水平
建议小区增加安全保障	安全秩序没保障
物业管理粗暴和收取停车费不合理	管理简单粗暴
市民认为物业疏通管道还要自己花钱不合理	入户维修态度及质量差
住建委电话无人接听	管理费
小区保安不正规问题	保安不当行为
希望改善物业工作方法	管理简单粗暴
协调相关部门解决增加暖气片片数	质量和水平
迟迟没有安装门禁	安全秩序没保障
强行占地的问题	安全秩序没保障
协调归还家具问题	日常服务不到位
开发商不退契税钱	管理费
没有入户调查就成立业委会	组织、推选
市民反映小区监控实施损坏	监控实施损坏
毛纺南小区居委会欺上瞒下	质量和水平
快递柜旁边便溺影响自家生活问题	垃圾清运费
物业收费不合理	垃圾清运费
社区要求换同样的窗户	管理简单粗暴
协调维修监控	监控实施损坏
更换电梯不使用公共维修基金不合理问题	申请与使用
小区不合理收费问题	物业费
投诉物业效率低问题	管理简单粗暴
物业维修质量差	入户维修态度及质量差
成立业委会问题	组织、推选
希望小区安装监控设施	监控实施损坏
小区物业管理混乱	态度与规范
物业乱收费	管理费
违法违规建停车场	管理简单粗暴
希望物业加强小区安全管理	安全秩序没保障
龙岗路清源东里小区1号楼门前地砖和收报纸亭子坏了问题	管理简单粗暴
协调街道协助业主成立业主委员会问题	权力运作及监督
自己车胎被扎问题	安全没保障
多次检查影响正常生活	权力运作及监督
物业乱扣费	物业费
投诉马连洼街道书记朱利忠不作为	缴纳与监管
查询来电原因	管理简单粗暴
物业未公示提取公共维修基金明细	申请与使用
建议增设停车位	场地紧张
成立业委会	组织、推选
砖头占车位存在隐患	秩序混乱
希望物业加大力度监管小区人员进出问题	安全秩序没保障
小区住户往楼下扔东西问题	态度与规范
天通苑业委会主任工作问题#微博私信#	权力运作及监督
物业收取换主管道到水表的节门费用不合理	管理费
物业收费不合理”12385热线来电“	管理费
乱收费问题	秩序混乱
新物业人员聚集存在安全隐患	质量和水平
小区没有物业和业委会导致生活不便，希望尽快成立	组织、推选
居委会换届选举问题	组织、推选
协调处理让小区物业加强对车位的管理	安全没保障
物业租赁部长期把大量住宅房源租给公司办公不作为#市政府门户网站互动交流平台#	工作效率低
物业公司乱收费	管理费
投诉金碧物业限制周六日施工	管理简单粗暴
希望将电表闸、水闸和暖气阀的房门开着别锁	质量和水平
海悦公馆小区部分摄像头故障物业不予处理	监控实施损坏
物业不给买电不合理	管理简单粗暴
物业管理差	安全没保障
核实居委会筹备组组长工作办法是否合理	组织、推选
收卫生费不合理	自供暖社区供暖费
反映物业不作为导致车被刮蹭的问题	监控实施损坏
希望小区加强管理狗随地小便的问题	工作效率低
物业乱涨价	管理费
帮助了解监控管理部门	监控实施损坏
保安扰乱小区正常生活秩序	保安不当行为
物业乱作为|保密	质量和水平
物业收取标准不合理	物业费
电梯紧急呼救无人接听的问题	质量和水平
投诉保安服务态度差的问题	保安不当行为
要求奥林匹克花园三期开设北南门#市政府门户网站互动交流平台#	日常服务不到位
物业不作为的问题	质量和水平
划停车位影响生活希望取消问题	安全没保障
金泰大厦物业每次只能充五元电费不合理	自供暖社区供暖费
地下车库水管漏水	安全没保障
小区无法安装移动宽带的问题。	日常服务不到位
一杆一车设备的摄像头被堵	秩序混乱
业主委员会宣布公告不合法	权力运作及监督
物业不配合办理营业执照	质量和水平
物业不作为的问题	工作效率低
物业未公示专业基金费用不合理	缴纳与监管
业委会不作为	权力运作及监督
施工车辆随意停放在小区内，导致小区内停车秩序差	秩序混乱
小区内管理差问题	安全秩序没保障
加强康泽佳苑小区的管理【北京市委书记蔡奇】#人民网地方领导留言板#	工作效率低
贴出告示通知清理楼道产生一系列不合理事情	管理简单粗暴
了解是否可以交一个月的费用	管理费
了解和义西里小区停车位划分问题进展	秩序混乱
物业值班人员因停车问题辱骂业主不合理	管理简单粗暴
物业收取停车费不合理的问题	管理费
小区内多处监控故障	监控实施损坏
相关部门协调尽快启动电动车地库	质量和水平
核实房地产开发经营公司有没有交公共维修基金	缴纳与监管
物业收费不合理的问题	物业费
垃圾清运收费标准	垃圾清运费
公布将府家园北里公共维修基金使用情况	缴纳与监管
物业收取费用不合理问题。	物业费
物业收取租户停车费价格过高	收费不合理
车位价格不合理	管理费
核实处理小区存在安全隐患问题【北京市委书记蔡奇】#人民网地方领导留言板#	日常服务不到位
希望协调物业退费的问题	管理费
无法正常出入问题	管理简单粗暴
物业乱收费问题	垃圾清运费
没有修建防火围墙	安全没保障
希望禁止让大车在上下学时进入小区/保密	安全秩序没保障
监控摄像头损坏	监控实施损坏
建议王府温馨公寓小区完善摄像头监控设施的问题#微博私信#	监控实施损坏
小区物业问题	垃圾清运费
物业乱收费	物业费
小区之前停车管理公司私自延长收费年限，退出后未退费，近期小区又引入一家新的停车管理公司，重新收取停车费，居民对此意见大	秩序混乱
 施工没有公示牌不合理	工作效率低
违规安装监控	监控实施损坏
物业私自动用公共维修基金维修避雷针，业主对此意见大	权力运作及监督
车辆九点以后出商场不合理	收费不合理
物业收取物业费不合理	物业费
大队收取垃圾费/保密	垃圾清运费
物业私自调高物业费，并且捆绑收取电费，业主对此意见大	管理简单粗暴
物业动用维修基金不符合规定程序	申请与使用
物业未设计垃圾集运站，指定收取高价垃圾清运费	垃圾清运费
夏各庄新城西区太阳能无法使用的问题	质量和水平
投诉绿城物业公司暴力撬门强行清理业主东西	管理简单粗暴
物业乱收费问题	物业费
物业使用维修基金过多”65603478热线来电“	申请与使用
小区居民不让家长接送孩子	态度与规范
物业挪用维修基金的问题	缴纳与监管
投诉物业工作方法	威胁恐吓业主
街道领导阻挠小区成立业委会，希望协调解决	组织、推选
保安骂人问题	保安不当行为
物业不让联通光纤及移动光纤及歌华有线及电信光纤进入小区不合理	管理简单粗暴
物业费收取不合理	物业费
物业费收取不合理	物业费
监控损坏无人维修	监控实施损坏
维修费	缴纳与监管
投诉邮政工作人员	态度与规范
未经业主投票选举成立业委会，对此意见大	权力运作及监督
希望续租车位	安全没保障
物业将存车管理承包给个人导致居民使用不便的问题	日常服务不到位
物业收装修管理费不合理	管理费
机动车乱停放占用消防通道的问题。	安全没保障
拆除地桩导致乱停车问题	秩序混乱
小区没有人管理问题	安全秩序没保障
保安态度恶劣	保安不当行为
使用共享单车和三轮车占用车位问题	秩序混乱
希望帮助解决外来车辆进入本小区停车	秩序混乱
物业不作为	日常服务不到位
共享单车乱摆放	秩序混乱
投诉物业不让安装充电桩和不给维修太阳能的问题	入户维修态度及质量差
马家堡路67号院杂物占车位问题#微博私信#	秩序混乱
希望街道罢免现业务会	权力运作及监督
都市芳园小区锦湖园5号6号别墅靠近路边一侧存在加工点的问题#市政府门户网站互动交流平台#	安全秩序没保障
尽快加固天窗盖子	安全秩序没保障
物业不让安装充电桩问题	管理简单粗暴
停车秩序差	秩序混乱
物业不作为	态度与规范
围墙上装铁刺且糊玻璃碴子不合理#微博#	安全没保障
希望成立小区业委会【北京市委书记蔡奇】#人民网地方领导留言板#	组织、推选
协调归还杂物	质量和水平
市民反映掉落线问题	安全没保障
出入口设置不合理	安全秩序没保障
投诉物业安装路灯不符合要求	威胁恐吓业主
办理门禁卡需先缴纳一年物业费，居民对此意见大	权力运作及监督
小区内智能垃圾分类机器故障，希望及时维修	质量和水平
通州区梨园久居雅园小区无法成立业委会问题【北京市市长陈吉宁】#人民网地方领导留言板#	组织、推选
物业出租车位不公平	态度与规范
希望相关部门协调调查帮助成立业委会	组织、推选
建议增设监控设备/保密	监控实施损坏
小区内绿地未经业主同意被划分为城市公园改造	安全秩序没保障
物业不作为	态度与规范
小区无社区居委会，导致居民办事困难，希望增设社区居委会	组织、推选
检查站保安工作态度恶劣并且拒不出示工作证	保安不当行为
路面坑洼以及树被破坏的问题	质量和水平
没有保安问题	入户维修态度及质量差
物业违规收取业主物业费，希望查处	物业费
小区内僵尸车占用车位问题	秩序混乱
投诉物业给业主停电	管理简单粗暴
收取物业费不合理	物业费
物业事先未征得业主同意，私自使用公共维修基金维修楼顶，业主对此意见大	申请与使用
物业清理僵尸车的同时，未进行公示，将业主车辆也清走了	态度与规范
投诉富力物业不服务收取管理费的问题	管理费
核实具体装修时间	质量和水平
协调安装充电桩【北京市委书记蔡奇】#人民网地方领导留言板#	安全没保障
物业不给供水问题	质量和水平
协调与物业公司的补偿问题	入户维修态度及质量差
停车管理公司私设车位并收费不合理	秩序混乱
核实监控是否打开是否损坏	监控实施损坏
业收取物业费不合理	物业费
非小区车辆占用本小区居民车位不合理	秩序混乱
去年冬天没有买暖气但是今年物业让补交采暖费	自供暖社区供暖费
监控坏了无人维修	监控实施损坏
投诉北京星湖开发公司	权力运作及监督
小区监控老化模糊	监控实施损坏
代步车占用机动停车位，希望及时处理	保安不当行为
旧物业迟迟不肯撤离的问题	组织、推选
物业公司工作人员态度恶劣	威胁恐吓业主
物业收取物业费不合理	物业费
物业拖着不给处理两个下水管的问题	态度与规范
小区内业委会成立、房屋质量、房产证发放问题（领导接听）	组织、推选
希望物业招收年轻保安加强小区管理问题	安全秩序没保障
核实物业出台收上门费规定的具体时间问题	物业费
监控坏了	监控实施损坏
摄像头安装不合理	监控实施损坏
希望相关部门让物业给业主一份动用维修基金的完整的材料	申请与使用
小区无人清理问题	管理简单粗暴
投诉香海园小区物业不作为封路不合理	安全秩序没保障
小区保安恐吓市民/保密	威胁恐吓业主
小区地下停车位不出租给业主	秩序混乱
物业乱收费	垃圾清运费
北京像素小区安装高清监控设备问题#微博#	管理费
惠兰美居小区物业收取车位管理费不合理问题	管理费
陈晨属于非业主但继续干涉业委会事情不合理	权力运作及监督
物业不让安装充电桩问题	管理简单粗暴
投诉保安打人	保安不当行为
投诉物业乱收费	管理费
未经业主同意，物业私自上涨人防车位停车费，居民对此不认可	物业费
小区安全没保障门卫形同虚设	安全秩序没保障
物业公司故意断电	物业费
保安私自丢弃业主物品	保安不当行为
合顺家园小区开发商乱收费问题	物业费
撤销反映	保安不当行为
小区地下车库不交给物业管理造成业主停车问题无法解决	秩序混乱
投诉小区物业不维修自来水阀门不合理	管理简单粗暴
小区物业费收取过高问题	物业费
物业费不合理	物业费
物业重复收取管理费及卫生费，居民对此意见大	管理费
居民楼开设便利仓库存放酒水，存在安全隐患，希望查处	安全秩序没保障
希望物业加强对小区外来车辆管理的问题	秩序混乱
物业不作为	日常服务不到位
协调小区入口留人抬杆	日常服务不到位
希望小区尽快成立业委会	组织、推选
物业随意泄露信息的问题	安全秩序没保障
门禁修缮	安全秩序没保障
小区卫生环境脏乱差，楼道堆放杂物不清理，希望加强管理	日常服务不到位
希望核实监控探头的产权信息	监控实施损坏
协调将车位迁移回小区停车楼一层	安全没保障
物业不管理不栓狗链遛狗	质量和水平
物业迟迟不退费的问题	物业费
自家门歪无人管	入户维修态度及质量差
物业要求自己补缴供暖费不合理	自供暖社区供暖费
物业动用公共维修基金违规操作和业主不同意再次公共维修基金	申请与使用
在小区内楼道里要有警力进行巡逻保护财产	质量和水平
未经过业主同意成立居委会	组织、推选
物业让交的物业费不合理	物业费
小区防盗门故障	申请与使用
反映物业私改停车场不合理问题	管理简单粗暴
擅自扣工资上保险	管理简单粗暴
小区大门敞开不合理	安全秩序没保障
晒被子影响周边环境	质量和水平
物业针对防火采光板没有合理方案	工作效率低
物业未经业主同意私自拆围墙	管理简单粗暴
物业收取垃圾清运费、管理费过高，希望帮助解决	垃圾清运费
居委会召集业主开会不是党员业主没有表决权不合理#微博#	组织、推选
不作为的问题	态度与规范
东城区房管局非法审批公共维修资金支取	缴纳与监管
小区内监控不清晰以及存在死角的问题	监控实施损坏
物业用公共区域私盖垃圾场和停车场问题	申请与使用
投诉街道不帮助成立业委会问题	组织、推选
海淀区五福玲珑居小区地下车库收费不合理问题/保密	收费不合理
小区停车管理混乱	秩序混乱
小区内监控设施故障，希望尽快维修	监控实施损坏
 投诉物业管理不当	管理简单粗暴
物业使用公共维修基金未与业主商量不合理	申请与使用
商务性公寓都在退公共维修基金，富力未按照规定退还	缴纳与监管
希望相关部门协调帮助成立业委会	组织、推选
物业乱收费的问题	物业费
提取维修基金不合理	申请与使用
业委会选举不公开不透露问题	组织、推选
小区成立业主委员会、街道一直阻挠	组织、推选
物业收取供暖费过高，业主对此意见大	物业费
希望物业对小区一层的院墙规划合理出口	申请与使用
住户在房屋充电瓶存在安全隐患问题	安全秩序没保障
物业乱收费	物业费
小区采取封闭式管理未提前通知，影响居民生活	受破坏及法律权益保障
建议小区内增加自行车车棚	态度与规范
经马坡镇政府核实，市民反映问题属于双丰街道管辖范围，建议转双丰街道办理。	工作效率低
市民反映非法停车问题	秩序混乱
永泰园第二社区停车问题#微博#	秩序混乱
希望把本小区加入到业主APP中	组织、推选
物业不让停车	安全没保障
增设小区安全防护的问题	安全秩序没保障
居委会收取停车费不合理	缴纳与监管
物业加强管理	日常服务不到位
占车位	秩序混乱
选举业委会只允许B座业主参与不合理	组织、推选
都市芳园小区物业收费不合理问题【北京市委书记蔡奇】#人民网地方领导留言板#	管理费
物业不作为的问题“12315热线来电”	质量和水平
门缝塞广告	态度与规范
小区内监控设施损坏，希望及时维修	监控实施损坏
停车位划的离楼门口太近的问题	秩序混乱
 投诉物业强制收保护费，掐断电	威胁恐吓业主
无法成立业委会的问题	态度与规范
认为门禁收费不合理	管理费
核实物业收取巡查管理费是否合理	管理费
停车管理人员私自出租车位	秩序混乱
物业收取天然气费用过高	自供暖社区供暖费
希望小区加入住建委推出的“北京业主APP”	组织、推选
希望物业加强保安素质培训问题	保安不当行为
业委会成立问题	组织、推选
农村卫生费收费标准	垃圾清运费
小区地库托底	安全没保障
小区保安态度不好要求开除问题	保安不当行为
吉庆里小区5号楼老是有人在电梯里面抽烟	日常服务不到位
物业不作为	工作效率低
市民反映希望延期缴纳供暖费也可以用电。	自供暖社区供暖费
小区物业有车证也不让进小区	日常服务不到位
垃圾清运费高不合理问题	垃圾清运费
小区保安服务不到位问题	监控实施损坏
莱圳家园小区业主管理的公共收益资金一直被物业非法侵占#APP#	组织、推选
停车混乱	秩序混乱
保安不让自己停在非固定停车位	保安不当行为
无法办理优惠停车的问题	权力运作及监督
经适房物业费按照商品房标准收取	物业费
小区物业不作为问题	质量和水平
小区过道被长期占用的问题	秩序混乱
怡兴物业强制收取垃圾清运费不合理	垃圾清运费
四海路1号院车库内无监控	安全没保障
小区门禁未上锁	安全没保障
物业费是按照使用面积还是建筑面积收取	管理费
减速带安装位置不合理/保密	安全没保障
投诉物业不让自己停车	安全没保障
小区停车问题无人管理	安全没保障
物业不修缮门禁和楼道天花板不负责	日常服务不到位
单位不予缴纳维修基金	缴纳与监管
小区内未安装监控设施，希望增设	监控实施损坏
社区私自出租小区车棚不合理的问题	安全没保障
门禁看管人员态度恶劣而且打人的问题	保安不当行为
希望物业公示维修供电设备使用的详细的金额	申请与使用
小区物业不负责任不管理小区事务的问题	质量和水平
物业乱收费	物业费
小区内停车位被占用的问题	秩序混乱
地下室居住物业人员以及家属不合理问题	质量和水平
小区监控不完善，导致车辆被划无法看到监控	监控实施损坏
安柜子导致出行不便	管理简单粗暴
物业多收取物业费	物业费
收费不合理	管理费
屋内消防管道漏水后续事情无人处理问题	质量和水平
物业不进行维修墙体	管理简单粗暴
门禁不能使用“65603424热线来电”	入户维修态度及质量差
希望职能部门核实居委会收业主钱是否合理问题	质量和水平
物业维修效率低、不公布维修基金使用情况，希望加强管理	入户维修态度及质量差
物业迟迟不取消固定车位	秩序混乱
公共车位被占用的问题	秩序混乱
物业收取高额电费和供暖费	自供暖社区供暖费
物业强制停电	物业费
物业私自动用维修基金	申请与使用
阳台维修	入户维修态度及质量差
物业不作为问题	态度与规范
物业收费不合理	管理费
小区内没有非机动车棚	安全没保障
物业乱作为	态度与规范
无停车位物业不让业主车进小区	入户维修态度及质量差
核实车位是否有正规手续、如果有手续解决规划不合理问题	安全没保障
物业收取租房押金的问题“12315热线来电”	管理费
小区楼道内灯泡损坏无人维修	日常服务不到位
希望在小区周边道路增设电子停车位	场地紧张
了解预交物业费和管理费是否合理/保密	物业费
楼道内随意堆放杂物，影响居民通行	质量和水平
投诉广外街道社区无人办公	组织、推选
物业乱收物业费	物业费
投诉物业公司@“12315热线来电”	物业费
投诉物业办事效率低问题	管理简单粗暴
小区摄像头损坏	监控实施损坏
单元楼门禁故障，希望及时维修	安全没保障
投诉物业停水问题	管理简单粗暴
小区内小广告太多	日常服务不到位
不能查看摄像头的问题	监控实施损坏
协调清理僵尸车	安全没保障
中关村南小区问题#微博私信#	安全秩序没保障
物业保安不作为	保安不当行为
收取物业费不合理	管理费
物业公司收取快递公司费用不合理问题	管理费
开发商限制业主签字办理房本不合理	缴纳与监管
业委会在组织投票过程中有严重违规现象	权力运作及监督
收费不合理	收费不合理
物业收费不合理	垃圾清运费
物业收取出门费不合理	管理费
协调安装监控	监控实施损坏
物业把业主信息发布到网上不合理问题	管理简单粗暴
护栏未安装固定	安全秩序没保障
小区保安不叫出门的问题	保安不当行为
物业多收水费不退钱问题	管理费
小区安保措施不到位问题	安全秩序没保障
商品房与两限房之间的栅栏围挡被两限房业主私自拆除，希望协调解决	质量和水平
希望尽快维修监控摄像头让其恢复使用	监控实施损坏
让重新参加摇号不合理	管理简单粗暴
希望城北街道给对方出一个车位的问题	秩序混乱
物业乱收费问题	管理费
物业服务质量太差	安全秩序没保障
安装宽带	日常服务不到位
市民反映窗户破损的问题	申请与使用
变成开放小区后停车秩序差	秩序混乱
北七家镇政府跟北京城建集团勾结坑害来百姓	威胁恐吓业主
市民反映私接电线问题	安全秩序没保障
建议小区增设门禁系统	申请与使用
住户在屋内充电动车车瓶存在安全隐患问题	安全秩序没保障
烧油汽车占用充电汽车停车位问题	管理简单粗暴
希望楼道大厅安装监控	监控实施损坏
希望小区可设置门禁	秩序混乱
私拉电线用于给电动车充电，存在安全隐患	安全没保障
小区摄像头不管用问题	监控实施损坏
物业未经业主同意更换门禁并收取费用，特助对此意见大	物业费
收费不合理	垃圾清运费
物业未按照政府文件降低商业电费，业主对此意见大	物业费
物业收取停水费不合理	管理费
小区单元门门禁损坏问题	监控实施损坏
希望小区安装摄像头	监控实施损坏
清理汽车上的水泥点	态度与规范
投诉小区物业不作为	日常服务不到位
无法退装修押金	管理简单粗暴
无法插电卡	质量和水平
强制收房的问题	态度与规范
投诉停车多收费工作人员态度恶劣	收费不合理
投诉朝阳区双井街道富力城小区物业物业费不合理/保密	物业费
物业收取费用不合理	管理费
电动车停在单元楼门口存在安全隐患	安全没保障
物业不作为	态度与规范
物业收取装修管理费和押金不合理	管理费
小区物业强制收取装修垃圾费问题	垃圾清运费
协调开放小区通行使用	日常服务不到位
物业不公开中央空调出风量明细	自供暖社区供暖费
住房水槽返水没有解决问题	入户维修态度及质量差
希望尽快解决韦伯豪小区南门物业值班室被封的问题	安全秩序没保障
能否成立业委会问题	组织、推选
小区内环境卫生差的问题	日常服务不到位
居委会和物业不让成立业委会	组织、推选
居民楼底商开设医美类店铺不合理	日常服务不到位
小区内存在的大量问题	组织、推选
核实小区保安收取进门费是否合理	保安不当行为
投诉小区保安工作服务的问题	保安不当行为
催缴卫生费不合理的问题	管理费
小区52号楼南侧门口垃圾无人清理向物业反映后物业报复自己	威胁恐吓业主
一万米家园小区违规收费的问题	管理费
收取卫生费不合理	垃圾清运费
投诉小区物业工作态度和工作质量问题	威胁恐吓业主
投诉物业不作为的问题	工作效率低
投诉海淀区中关村街道强行占用服务社问题	态度与规范
安置房迟迟不售卖问题	管理简单粗暴
从楼上私拉电线充电动车	安全没保障
物业未经过业主同意私自清理物品	管理简单粗暴
小区物业收取垃圾清运费不合理	垃圾清运费
协调成立业委会问题	组织、推选
希望小区传达室重新管理小区停车问题	秩序混乱
希望重新推选居民代表	权力运作及监督
停车秩序差#微博#	秩序混乱
物业在未经通知情况下私自将内部道路改为公共道路不合理	申请与使用
物业乱收费	物业费
投诉小区物业没有值班人员不合理	质量和水平
安装铁栅栏合不合法的问题	日常服务不到位
投诉维修公司不作为“12315热线来电”	入户维修态度及质量差
监控器安装不合理想要撤掉	监控实施损坏
小区监控不好用	安全秩序没保障
物业私自断自己电梯门禁卡问题	态度与规范
物业频繁使用维修基金不合理	缴纳与监管
进不去院	管理简单粗暴
没有保安证执勤	保安不当行为
让交物业费不合理	物业费
希望物业尽快把自己自行车找回来	质量和水平
希望有关部门帮助核实费用明细的问题	物业费
协调物业帮忙调取监控	安全没保障
要求按照市民要求把窗户按在外面	态度与规范
业主私占公共停车位 	秩序混乱
不明诉求	日常服务不到位
物业擅自动用公共维修基金，自称用于维修消防系统，业主此意见大	申请与使用
小区物业管理差	收费不合理
协调加强小区停车管理	秩序混乱
车位价格不统一未公示，居民对此意见大	收费不合理
垃圾桶影响通行问题#微博#	秩序混乱
物业涨物业费不合理问题	物业费
老物业私自挪用公共维修基金问题	申请与使用
楼道内给电瓶车充电问题#微博#	安全没保障
房改产权是否需交物业费	物业费
小区大门被街道城建科私自拆除问题	管理简单粗暴
希望相关部门设置固定停车位	秩序混乱
小区内乱停车	秩序混乱
北京交警APP无法正常办理进京证问题	申请与使用
村子里监控设施损坏无人修理问题	监控实施损坏
无法充电	保安不当行为
物业不作为问题	态度与规范
投诉莱圳家园北区物业不作为问题【北京市委书记蔡奇】#人民网地方领导留言板#	质量和水平
物业不让快递进入小区问题	日常服务不到位
巩华新村小区保安私自锁车问题	保安不当行为
收取停车费不合理	管理简单粗暴
小区停车秩序紊乱	秩序混乱
小区现存问题#微博#	质量和水平
物业私自锁车	管理简单粗暴
小区地库频繁有人大小便，导致环境脏乱，希望安装监控设施	监控实施损坏
希望取缔业委会	权力运作及监督
投诉保安“12315热线来电”	保安不当行为
希望小区按照每月150元收取停车费问题	收费不合理
物业不退押金	物业费
大兴长子营镇政府的这两个保安态度不好	保安不当行为
居民楼开酒便利仓库存在安全隐患	安全秩序没保障
物业被责令取消，迟迟不从小区清退且继续收费，居民对此意见大	物业费
充电桩迟迟不通电	态度与规范
万科物业将地上车位租赁不合理	秩序混乱
业委会成立不合理	组织、推选
物业服务态度差	态度与规范
门禁门噪音扰民问题	日常服务不到位
卫生费过高	垃圾清运费
协调西红门镇政府尽快给小区业委会备案	组织、推选
地下停车场堆放杂物存在安全隐患	安全没保障
希望将监控安装好或者安装护栏	监控实施损坏
物业要求缴费后才给安装充电桩不合理	物业费
开发商收费不合理	物业费
物业收费不合理	物业费
物业擅自动用公共维修基金问题	缴纳与监管
驱赶捡垃圾的老人不合理的问题	保安不当行为
物业不作为	日常服务不到位
宝山居委会阻止碧桐园小区成立业委会	组织、推选
投诉物业无理由拒绝装宽带	入户维修态度及质量差
物业出售停车位不合理的问题	安全没保障
不交物业费就办理不了停车位	物业费
投诉物业不作为	物业费
协调制止物业自私改供暖问题	管理简单粗暴
解决砌台子	安全秩序没保障
物业阻止小区成立业委会	管理简单粗暴
小区物业违规找租户代替业主签字问题	申请与使用
大兴长子营镇政府的这两个保安态度不好	保安不当行为
投诉物业对不交物业费的居民不能参加小区停车位抽签不合理	威胁恐吓业主
停车场收费不合理问题	收费不合理
公摊面积收费不合理问题	物业费
强行收取停车费问题	收费不合理
新物业收楼道灯钱及划分车位不合理问题	缴纳与监管
物业费收取不合理	物业费
归还天秀花园古月园监控设施和监控室	监控实施损坏
 监控不能正常使用	监控实施损坏
建议居委会加强对胡同的管理	日常服务不到位
小区物业管理不到位问题	安全秩序没保障
居民私装充电桩存在安全隐患	安全没保障
单元门禁迟迟未启用，安保服务不到位	日常服务不到位
业委会违规填写选票问题	权力运作及监督
乱收公共维修基金	缴纳与监管
物业不作为	质量和水平
物业主任不作为要求把消防通道留出来	安全秩序没保障
希望处理小区内环境脏乱差	质量和水平
物业不退公共维修基金不合理	缴纳与监管
小区地下车库没有人管理问题	安全没保障
居民私自占用停车位不合理	秩序混乱
长龙苑小区物业乱收费问题#微博#	管理费
物业私自停水停电	质量和水平
外来人口管理费	管理费
楼顶年久失修往自家露台掉石块存在安全隐患	安全秩序没保障
来电希望相关部门安装电动车充电桩	申请与使用
监控设备损坏	监控实施损坏
小区楼道卫生无人管理问题	日常服务不到位
208号楼楼道卫生差问题	日常服务不到位
小区业委会推选成立	组织、推选
撤销反映	日常服务不到位
业委会工作不到位希望由居民重新选举	权力运作及监督
租户强行在写字楼楼顶接电源	质量和水平
希望协调把门上的胶去除	日常服务不到位
来电反映物业管理不到位问题	态度与规范
物业私自在11号楼楼下动工盖楼问题	入户维修态度及质量差
停车收费不合理的问题	收费不合理
街道不给办理业委会相关手续不合理	组织、推选
信诚物业不作为“12320热线来电”	质量和水平
龙华园小区东区物业工作质量差	质量和水平
协调退房问题	管理简单粗暴
物业收费不合理	垃圾清运费
青年社副书记王文东拉票的问题	权力运作及监督
小区内停车混乱的问题	秩序混乱
反映物业不允许市民安装充电桩问题	安全没保障
1-6号楼业主无法参选业委会参选	组织、推选
楼道有恶臭味道	安全秩序没保障
协调街道维修单元门                        	权力运作及监督
小区门口栅栏设置不合理的问题	日常服务不到位
因不清楚所属街道导致无法成立业委会	组织、推选
物业泄露个人信息	入户维修态度及质量差
物业挪用公维资金未经业主同意，对此意见大	缴纳与监管
电费价格高问题	质量和水平
红线胡同治安摄像头故障无人处理	监控实施损坏
小区停车收费标准不合理	管理费
小区规划停车位不合理	秩序混乱
希望尽快成立正规业委会	受破坏及法律权益保障
幼儿园把铲绿地了铺上砖不合理	质量和水平
通过窗户给楼下的电动车充电存在安全隐患	安全秩序没保障
撤销问题	保安不当行为
物业不作为	入户维修态度及质量差
店铺被占	态度与规范
希望帮助联系物业退费	垃圾清运费
希望治理高空抛物的问题	质量和水平
合理规划停车位	安全没保障
物业不作为的问题	安全没保障
增设摄像头	监控实施损坏
希望增设监控设施	监控实施损坏
物业不作为	质量和水平
 希望尽快成立业委会	权力运作及监督
人防局在地下车库喷漆后存在甲醛超标问题	安全没保障
垃圾清运费收取不合理	垃圾清运费
希望有关部门在这个位置安装治安摄像头的问题	安全秩序没保障
物业不退装修押金	管理费
物业不履行职责	管理简单粗暴
小区物业收取水泵加压费不合理问题	物业费
希望改造房屋安装晾衣架	日常服务不到位
物业私自拆除小区围墙建设大门问题	管理简单粗暴
都市芳园小区物业收费不合理问题#微博#	管理费
自己没带身份证月城中心B座保安不让自己进	保安不当行为
物业态度恶劣	态度与规范
村委会收取卫生费不合理	物业费
物业不作为	质量和水平
希望补充回访信息	监控实施损坏
车辆出入杆损坏小区停车位被外来车辆停占	安全没保障
楼梯上挂了一辆自行车太危险问题	日常服务不到位
帮助恢复小区所有摄像头功能	监控实施损坏
丰台和义西里三区停车秩序混乱【北京市委书记蔡奇】#人民网地方领导留言板#（二次）	秩序混乱
 物业擅自提高物业费不合理	物业费
小区内私拉电线充电，存在安全隐患	安全秩序没保障
石榴园小区北里物业给强制断电问题	管理简单粗暴
社区不给开证明	权力运作及监督
希望协调维修小区监控	监控实施损坏
景区工作人员工作不合理、希望帮助自己买票	态度与规范
物业公司工作人员态度恶劣	威胁恐吓业主
小区内收取物业费不合理的问题	物业费
瓷砖占用停车位	日常服务不到位
物业不作为问题	日常服务不到位
希望成立业主委员会问题	组织、推选
门卫区别对待不让物流车进入小区	保安不当行为
小区晚上没有保安值班	日常服务不到位
御路园私占车位#市政府门户网站互动交流平台#	安全没保障
物业收取停车费不合理	收费不合理
开发商不移交车库导致居民无位置停车	安全没保障
车辆停在小区里面被撞物业摄像头损坏不给处理	安全没保障
未签署物业服务合同收取物业费	物业费
海鸿物业不提供物业服务还无理催费用的问题	物业费
车棚内存在垃圾无人处理	安全没保障
未经业主同意，物业私自进行摇号出售车位，居民对此意见大	收费不合理
建议三间房线乡派出所保安加强素质	保安不当行为
协调处理棕榈泉国际公寓成立业委会/保密	组织、推选
物业不退还停车费，希望帮助处理	管理费
楼上楼下物业费不一样	物业费
建议装修垃圾站换一个位置	质量和水平
私划停车位收费不合理的问题	管理简单粗暴
在地下室住人存在安全隐患	安全秩序没保障
物业乱收供暖费	自供暖社区供暖费
断冷气的问题	态度与规范
地下停车场堆放垃圾和泔水不合理	管理简单粗暴
希望双丰街道纠正错误做法，恢复原来的投票方式。	组织、推选
单位不给报销物业费“12320热线来电”	物业费
物业不修水管开关总阀	入户维修态度及质量差
通道有人居住/保密	质量和水平
小区内没有监控问题“12315热线来电”	监控实施损坏
物业额外收取厨余垃圾费用是否合理	管理费
停车场紧挨着居民楼建设不合理	安全没保障
小区电子眼故障导致无法处理车链子锁无故被人损坏	监控实施损坏
反映物业收费不合理	物业费
小区物业增设摄像头的问题	监控实施损坏
从楼上往楼下拉线充电动车不合理	安全没保障
小区安全问题	安全秩序没保障
不让租户在小区内停车	秩序混乱
收取停车位费用不合理问题	物业费
海淀区当代城市家园小区业主委员会私自办理行为	缴纳与监管
物业强制要求缴纳滞纳金不合理	物业费
商品房和两限房混居不合理问题	日常服务不到位
市民反映让物业停止施工的问题.	申请与使用
小区树上掉杂物	安全没保障
地坛北里11号楼楼没有安装摄像头	安全秩序没保障
小区没有安全保障的问题	安全没保障
房山区物业费收取标准	物业费
希望帮助协调安装护栏	安全没保障
街道不同意申请业务会	权力运作及监督
云岗南宫志苑小区物业乱涨物业费不合理	物业费
投诉物业未经业主同意私自动用维修基金并且不作为的问题	申请与使用
停车位场地紧张的问题	场地紧张
安装充电桩#APP#	态度与规范
小区安全秩序差安全得不到保障	安全秩序没保障
小区收废品占用业主停车位不合理	秩序混乱
物业管理不善问题	秩序混乱
物业对未交公共维修基金住户停止服务	缴纳与监管
维修窗户	入户维修态度及质量差
小区未公开选举业委会成员，居民对此意见大	组织、推选
物业恶意涨房租	管理费
投诉永顺镇物业办	组织、推选
投诉居委会收取停车费不合理的问题	管理费
水管开裂无人处理	质量和水平
物业单独收取楼道灯费用，业主认为不合理	管理费
小区物业不作为并威胁业主	威胁恐吓业主
朝庭公寓成立业委会征求意见流程不合理	组织、推选
协调退押金	态度与规范
雍贵大厦B座咨询台工作人员生硬	管理简单粗暴
华润置地物业公司收取新能源设备电费不合理	管理费
双惠苑小区物业私设小客车出入关卡并强行收费不合理	收费不合理
希望相关部门对物业交接进行监管的问题	态度与规范
胡同口停车管理不规范	秩序混乱
物业不让其他公司员工进入小区	管理简单粗暴
楼道卫生无人打扫问题	日常服务不到位
物业不作为	态度与规范
投诉旭辉地产	管理简单粗暴
无法联系商务委递交表格	日常服务不到位
安全得不到保障的问题	安全秩序没保障
小区摄像头	监控实施损坏
投诉朝阳区CBD行政服务中心效率低	工作效率低
建议成立业委会不合理的问题	组织、推选
小区内建设学校接送孩子影响小区居民出行	安全秩序没保障
楼道里停放自行车	秩序混乱
北七家镇政府跟北京城建集团勾结坑害来百姓	威胁恐吓业主
核实物业不让三轮车进入小区的原因	日常服务不到位
小区内居民使用燃气管道晾被子，存在安全隐患	日常服务不到位
投诉澳特朗售后	入户维修态度及质量差
晚上收取物业费不合理	物业费
小区业委会没有成立	组织、推选
违法办公问题	受破坏及法律权益保障
邻居威胁	威胁恐吓业主
物业收费清理装修垃圾是否合理	垃圾清运费
小区宽带迟迟无法通电使用问题	监控实施损坏
物业收费不合理”12385热线来电“	管理费
僵尸车占用公共车位，希望及时清理/保密	秩序混乱
外来车辆随意进入小区停放，希望加强管理	安全没保障
小区物业工作差问题	质量和水平
物业收取垃圾清运费是否合理	垃圾清运费
投诉物业门卫	保安不当行为
小区若干问题	安全秩序没保障
装修要交装修管理费不合理，希望查清	威胁恐吓业主
收取物业费不合理	物业费
私自将停车场改珠宝城存在安全隐患	安全没保障
物业属于非法组织	安全没保障
物业阻拦居民车辆禁止驶入小区，居民对此意见大	态度与规范
业委会未经业主同意更换物业问题	权力运作及监督
收费人员乱收费	保安不当行为
熙悦诚郡小区停车秩序差	秩序混乱
小区环境脏乱差	垃圾清运费
物业未入户维修客厅灯	入户维修态度及质量差
希望安装监控设施的问题	监控实施损坏
人大附中翠微中学（卫国中学）保安态度恶劣	保安不当行为
物业公司私自动用大修基金/保密	管理简单粗暴
小区保安不让进入小区接送孩子#微博私信#	保安不当行为
青年社副书记王文东拉票的问题	权力运作及监督
物业乱收费	管理费
物业拒收电费	质量和水平
物业带人殴打业主	威胁恐吓业主
核实如何下载北京业主APP	申请与使用
协调在北京业主APP进行公示注册	权力运作及监督
了解收税是否合理	管理费
业委会问题	组织、推选
物业不作为	态度与规范
无处停车问题	场地紧张
小区停车秩序混乱，希望尽快治理	秩序混乱
物业暴力执法	态度与规范
五福玲珑居小区1至11号楼环境脏乱差问题#微博#	质量和水平
物业不作为的问题/保密“12315热线来电”	态度与规范
物业费收取不合理	物业费
小区问题	安全秩序没保障
物业收装修垃圾清运费高问题	垃圾清运费
了解是否可以单独成立业委会	组织、推选
投诉大屯街道和慧中里小区物业工作方式不规范的问题	态度与规范
物业不让装修商铺	管理简单粗暴
不让停车不合理	秩序混乱
物业公司乱收物业费	物业费
私拉电线问题	安全秩序没保障
收外地人1000元垃圾费是否合理/保密	垃圾清运费
物业保安（宫春泼）骂人以及向自家泼尿	保安不当行为
物业未入户维修客厅灯	入户维修态度及质量差
开阳里小区水压小问题	质量和水平
垃圾清理费	垃圾清运费
监控不能正常使用	监控实施损坏
帮助在小区单元门安装门禁的问题	安全秩序没保障
物业重复收取车位费	管理费
货车进出小区存在安全隐患	安全没保障
投诉兴辰大厦物业公司不作为问题#微博#	管理简单粗暴
投诉物业不作为问题。	物业费
小区业委会未按规章制度办事，希望进行整改	权力运作及监督
老物业非法霸占停车位导致无法正常停车	态度与规范
物业乱作为态度差未经同意进入自家维修问题	质量和水平
物业收取地下水使用“12369热线来电”	日常服务不到位
物业不登记车辆信息	申请与使用
小区供暖收费不合理问题	自供暖社区供暖费
物业监管不严	安全秩序没保障
了解西府颐园小区车位改造规划以及是否有审批手续	安全没保障
孩子乱穿行小区存在安全隐患	安全秩序没保障
解决小区监控失修存在安全隐患问题【北京市委书记蔡奇】#人民网地方领导留言板#（二次）	监控实施损坏
家委会工作人员私自出租办公室/保密	权力运作及监督
摄像头故障	监控实施损坏
物业滥用职权问题	缴纳与监管
物业人员不作为	入户维修态度及质量差
物业拔掉小柏树不合理	管理简单粗暴
物业不作为	质量和水平
小区没有监控	监控实施损坏
维修更换管道乱收费用不合理的问题	日常服务不到位
核实自己家安装暖气片是否安装物业规定安装多少片	管理费
小区物业管理不完善的问题	质量和水平
五城社区居委会和街道不让成立业委会	组织、推选
希望办理停车证	秩序混乱
小区允许外来车辆进入不合理	安全没保障
北京顺天通物业管理有限公司拆除电表程序不合理希望尽快帮助安装电表问题	质量和水平
建议会汇龙文苑小区多增设摄像头	监控实施损坏
物业不给解决问题	质量和水平
街道回复方式不合理	权力运作及监督
业委会无法成立	受破坏及法律权益保障
小区里面监控设施损坏问题	监控实施损坏
北京市龙安润达停车管理服务有限公司做法不合理	秩序混乱
物业动用公共维修基金不合理	申请与使用
垃圾清运费费用过高的问题	垃圾清运费
小区内安装钉子不合理	安全秩序没保障
小区单元门无人修理	入户维修态度及质量差
投诉员工态度问题	态度与规范
非正规物业的问题	入户维修态度及质量差
物业强制收取服务费“12315热线来电”	管理费
业委会主任贪污	权力运作及监督
筹备组组长贾秀杰不作为问题	组织、推选
协调开放西门	日常服务不到位
希望增高铁栅栏并安装摄像头	安全秩序没保障
不交物业费不让进小区不合理	物业费
物业阻碍业主参与维修电梯过程。	缴纳与监管
治安岗亭的男保安行为不当	保安不当行为
安装快递柜	日常服务不到位
咨询购房公共维修基金问题“12315热线来电”	申请与使用
希望清理车棚内的纸箱纸盒	质量和水平
城管将自己称抄了向自己索要罚款不合理的问题	质量和水平
成立业务会选举影响居民生活问题	组织、推选
小区内花园安装喷水装置导致路面湿滑，希望尽快拆除	日常服务不到位
自家的锁无法打开	安全秩序没保障
车被堵无法出行	秩序混乱
希望尽快维修小区内的监控和检修电梯/保密	监控实施损坏
物业借房屋漏水原因收取居民公工维护基金	缴纳与监管
摄像头没开问题	监控实施损坏
希望协调成立居委会	组织、推选
物业迟迟不开冷气空调#微博私信#	日常服务不到位
小区门卫扣押行驶本不合理	保安不当行为
小区成立业委会受居委会及物业阻碍	受破坏及法律权益保障
物业维修态度及质量差问题	入户维修态度及质量差
小区内物业不通电的	监控实施损坏
小区停车混乱无人管理问题	安全没保障
物业迟迟不给维修	入户维修态度及质量差
物业未提前告知业主动用维修基金	申请与使用
投诉物业不作为问题	态度与规范
绿城雅居物业乱收费问题#今日头条私信#	垃圾清运费
小区监控设施损坏无人维修，影响居民生活	监控实施损坏
业主委员不交物业费	质量和水平
物业肆意断水断电	管理简单粗暴
反映物业收费不合理的问题	物业费
蔚云府小区业委会迟迟无法成立	组织、推选
地下室经营游泳馆影响居民生活不合理	安全秩序没保障
小区物业不安装5G网络	态度与规范
投诉小区物业工作不负责	管理简单粗暴
物业水电费乱收费	物业费
物业私自售卖车位	质量和水平
小区内随意堆放玉米秸秆，希望尽快清理	安全秩序没保障
有人在自己窗户底下停三轮车	秩序混乱
物业私涨物业费，居民对此意见大	物业费
居委会不作为	组织、推选
物业私自停水	质量和水平
莱圳家园小区业主管理的公共收益资金一直被物业非法侵占#APP#	组织、推选
前楼长没有交接完成手续	组织、推选
鸟在居民楼筑窝扰民	安全秩序没保障
投诉物业未经业主允许私自断电的问题	威胁恐吓业主
小区规定登记车辆可以进入小区，因业主频繁更换车辆，导致保安阻拦，业主认为不合理	保安不当行为
物业服务态度恶劣	入户维修态度及质量差
希望推迟收垃圾的时间	垃圾清运费
希望协调尽快成立业委会	组织、推选
小区业委会管理混乱	权力运作及监督
不给开证明无法办理营业执照	日常服务不到位
维修窗户需街道城建科同意不合理	入户维修态度及质量差
物业不作为的问题/保密	日常服务不到位
领导不管物业不作为问题	管理费
划停车位不合理问题	安全没保障
物业保安不作为	保安不当行为
社保所工作人员招聘的社区保安不符合条件	保安不当行为
物业不给开启电梯	态度与规范
安装门把手	申请与使用
小区停车收费不合理，希望处理	收费不合理
小区安保问题	安全秩序没保障
物业卷款逃跑	物业费
办理业主委员会问题	组织、推选
要求天通苑小区公开工作内容及工作安排#微博私信#	权力运作及监督
咨询物业是否有权锁楼道内的电表和水表箱子	管理简单粗暴
业委会操控物业给小区居民无故停水	组织、推选
希望相关部门修复屋子的问题	质量和水平
了解装修垃圾是否需要经过物业处理并交纳物业费	垃圾清运费
物业不让进入小区停车不合理问题	安全没保障
幸福家园物业被庇护问题#微博#	权力运作及监督
反映车辆被淹无人处理	安全没保障
小区没有宽带不合理	日常服务不到位
门禁损坏无人处理的问题	安全秩序没保障
要求物业赔偿损失	态度与规范
希望给小区安装摄像头	监控实施损坏
监控录像无法调取	安全秩序没保障
乱停车	秩序混乱
停车收费不合理	收费不合理
物业收取停车费过高	物业费
希望重新建造台阶和坡道	权力运作及监督
车辆被剐蹭不给调取监控	监控实施损坏
没有入户调查就成立业委会	受破坏及法律权益保障
希望核实处理小区没有监控问题	监控实施损坏
小区卫生环境脏乱差及路面坑洼不平物业不予处理的问题	质量和水平
小区物业收取这么高的的物业费是否合理“12358热线来电”	物业费
物业保安队长骂人	保安不当行为
投诉物业态度不好不解决问题的问题	入户维修态度及质量差
街道拖延成立小区业委会	管理简单粗暴
招聘物业竞标流程作弊，业主要求取消花样年物业竞标资格	组织、推选
化粪池返臭味	工作效率低
物业收取滞纳金不合理的问题	物业费
物业不卖电	态度与规范
物业费收取太高了	物业费
投诉物业不作为问题#微博私信#	安全没保障
同馨家园小区物业收费不合理问题	垃圾清运费
物业未公示收取物业费明细，业主对此意见大	管理费
投诉物业不修理楼导致墙体脱落砸坏自己车辆	质量和水平
物业收取换主管道到水表的节门费用不合理	态度与规范
市民反映小区物业不作为问题	保安不当行为
建议小区进行灭蝇	管理简单粗暴
公正的成立业委会	组织、推选
希望尽快维修窗户	入户维修态度及质量差
中奥嘉园密封式清洁站被出租不合理问题#微博私信#	管理简单粗暴
小区管理质量差	监控实施损坏
物业收物业费不合理	物业费
物业停电梯不合理问题	管理简单粗暴
阳台快塌了无人修复	日常服务不到位
小区无法成立业委会	组织、推选
帮助恢复小区所有摄像头功能	监控实施损坏
拆除小区大铁门不合理	质量和水平
希望街道撤回开业主大会和成立业主委员会申请的批复	组织、推选
拆除隔离墩问题	安全没保障
物业收取停车费不合理	收费不合理
开发商未经业主同意改变自行车停车库	秩序混乱
协调解决业委会阻止施工建房问题	权力运作及监督
安贞西里占车位不合理	秩序混乱
畅悦家园小区内私装隔离门#微博#	态度与规范
物业违规出租垃圾站问题	态度与规范
楼道内外停自行车存在安全隐患问题	安全没保障
物业收费停车管理费不合理的问题	管理费
小区还未使用北京业主APP软件，希望尽快增设	组织、推选
物业不更改车辆停车信息导致无法进入小区	管理费
砖厂南里小区物业费收取不合理问题	物业费
希望外卖车辆禁止进入垡头西里小区	日常服务不到位
小区环境卫生差	日常服务不到位
拆除铁丝网	管理简单粗暴
将小区划分由两个物业公司进行管理，业主对此意见大	权力运作及监督
投诉小区物业不作为	质量和水平
物业在没有消防资质的情况下安装新能源汽车的充电桩问题	安全没保障
没有充电桩导致居民在楼道充电	安全没保障
投诉亦庄镇12345	态度与规范
物业使用维修基金过多	申请与使用
物业公司无停车收费资质	收费不合理
希望业主能随时了解电表剩余电量方便及时充电费问题	质量和水平
蓝调沙龙小区人防工程被物业出租经商#市政府门户网站互动交流平台#	安全秩序没保障
希望街道帮助启动业主委员会改选程序	权力运作及监督
物业乱收费	垃圾清运费
核实楼内卫生属于哪里管理	日常服务不到位
物业私自使用公共维修基金，居民对此意见大	申请与使用
小区门口放杆不合理	保安不当行为
车被划了	保安不当行为
咨询长期不居住的房子是否收取物业费	物业费
协调修小区道路	申请与使用
小区单元门通讯电话机器故障问题	安全秩序没保障
商住两用公寓水费电费收费过高，希望查处	管理费
希望尽量帮助协商南华小区出售产权	日常服务不到位
非法出租房子用于商业问题	入户维修态度及质量差
鼎秀美泉小区迟迟未成立业委会问题	组织、推选
物业不让快递进小区送件不方便	管理费
小区立体停车位被查封，导致停车秩序混乱，希望尽快解决	安全没保障
物业收费停车费和广告费，未向业主进行公示，居民对此意见大	缴纳与监管
不让在自己院里种植植物	管理简单粗暴
投诉物业服务不合格	质量和水平
家属委员会的工作人员不作为问题	质量和水平
成立物业不合理	态度与规范
小区跳蚤特别多	入户维修态度及质量差
投诉建委监管不力的问题	缴纳与监管
玻璃出现质量问题	申请与使用
物业乱收费	管理费
车位被非法占据	安全没保障
物业以权谋私问题	质量和水平
海淀区房管局七所不给开具有固定车位证明导致无法安装充电桩问题	态度与规范
小区内停车制度不合理#市政府门户网站互动交流平台#	秩序混乱
通用博园小区公共停车场收费不合理问题【北京市委书记蔡奇】#人民网地方领导留言板#（待解释）	收费不合理
裕中东里4号楼1单元门禁损坏的问题#评论#	申请与使用
物业收管理费的指导价问题	管理费
北苑街道万达广场写字楼物业不允许联通新业务进入	质量和水平
物业收取渣土清运费不合理	垃圾清运费
业委会出租小区大堂当商业用途出租不合理	权力运作及监督
私装地锁	秩序混乱
街道工作班不作为	管理简单粗暴
门卫不给开门	保安不当行为
北京城建物业管理有限公司管理混乱	安全秩序没保障
希望核实物业什么时候开始招标	组织、推选
小区物业不作为问题	管理简单粗暴
投诉瑞航物业不合理要求	管理简单粗暴
物业收取停车费不合理	管理费
物业收费太高	物业费
物业查表工作不到位导致多收自己水费	管理费
物业没有备案就租售房屋	质量和水平
拆除小区门口栅栏	态度与规范
楼道卫生无人清理	垃圾清运费
希望尽快成立业委会	组织、推选
希望小区尽快完成剩下的安装工作	监控实施损坏
希望尽快安装摄像头	安全秩序没保障
电梯故障	入户维修态度及质量差
违法停车	安全没保障
商店强制关门不合理	权力运作及监督
电动车乱停乱放的问题	秩序混乱
人防车位的产权及租赁规定	安全没保障
私自成立自管会跟私自收取停车费不合理	组织、推选
老物业拒绝撤离#微博私信#	质量和水平
旭辉御锦小区物业收物业费不合理	物业费
烟感堵塞物业不处理	入户维修态度及质量差
物业未经业主同意上涨停车费，且将绿地改为停车场，业主对此意见大	态度与规范
公共维修基金交取的问题	缴纳与监管
停车场设立地点不合理问题	安全没保障
希望尽快成立新的业委会	组织、推选
建议安装监控的问题	监控实施损坏
停车位停车秩序差，希望治理	秩序混乱
物业不让外地人在小区内停车不合理问题	态度与规范
业主委员会成立过程未公示	组织、推选
保安乱收费	保安不当行为
小区内停车秩序混乱，希望加强管理	秩序混乱
物业不作为的问题	安全没保障
小区监控故障未及时维修	监控实施损坏
小区内监控损坏，希望尽快维修	监控实施损坏
物业工作人员辱骂业主	威胁恐吓业主
小区内停车秩序无人管理	秩序混乱
物业和开发商违规售卖停车位	管理简单粗暴
自家门前停车影响出行问题	秩序混乱
在小区内楼道里要有警力进行巡逻保护财产	质量和水平
希望在同馨家园小区安置居委会	组织、推选
不给钱不让进小区是否合理	物业费
物业不作为	日常服务不到位
邑上原注小区物业不让快递进小区不合理	管理简单粗暴
物业无法更换配套报警器的问题	入户维修态度及质量差
莱圳家园小区业主管理的公共收益资金一直被物业非法侵占#APP#	组织、推选
居民楼墙体遍布小广告，楼梯扶手损坏，希望物业加强管理	态度与规范
监控设施不全	监控实施损坏
私拉电线充电	安全没保障
物业乱收费	物业费
希望帮助退房问题	安全秩序没保障
卫生费收费不合理问题	管理费
希望取消门禁	监控实施损坏
居民楼外墙瓷砖脱落问题	安全秩序没保障
核实小区业主委会审批不过的原因	组织、推选
单元门禁不投入使用	管理简单粗暴
 物业管理松散	态度与规范
城管让社会人员进入小区不合理	安全秩序没保障
反映物业管理差、供暖收费不合理、停车位问题(领导接听) 	态度与规范
咨询小区停车是固定的合不合理	秩序混乱
物业让售卖不明保健品的人进入小区不合理的问题	保安不当行为
社区不管问题	日常服务不到位
物业限制购电量不合理	管理简单粗暴
帮助成立业主委员会	组织、推选
切断供暖不合理问题	管理简单粗暴
物业拆除观景走道不合理	日常服务不到位
无法调取小区公共维修基金档案	权力运作及监督
物业动用维修基金不给更换电梯	缴纳与监管
清理楼道沙土灰尘	日常服务不到位
亮马桥东方东路1号联邦公寓无法成立业委会问题	组织、推选
协调劲松街道监控中心尽快查看监控	监控实施损坏
小区内环境脏乱，希望物业加强管理	质量和水平
111号楼周边无垃圾桶，希望增设垃圾桶，方便居民倒垃圾	日常服务不到位
居民楼营业宾馆，希望查处	安全秩序没保障
小区物业不作为	日常服务不到位
希望核实物业收取500块钱修插座线路押金是否是正常流程	管理费
物业乱收费问题	管理费
物业给断电	管理简单粗暴
东铁营街道蒲黄榆三里南门不开启	权力运作及监督
小区保安不让业主进入小区不合理	保安不当行为
小区公共设施质量差，存在安全隐患	入户维修态度及质量差
停车场管理差	安全秩序没保障
超市强行打开后门不合理问题	安全秩序没保障
地下车库地面损坏无人维修的问题	安全没保障
安馨建业房地产有限公司的物业不作为	态度与规范
地坛北里11号楼楼没有安装摄像头	安全秩序没保障
物业不让自己捡垃圾	质量和水平
物业不作为	态度与规范
投诉小区物业	监控实施损坏
监控实施损坏	监控实施损坏
欠物业费不让停车	物业费
物业强制涨物业费和电费	态度与规范
物业服务不到位	日常服务不到位
小区内改造停车场不合理	态度与规范
保安不值班	保安不当行为
可以安装电动充电桩	申请与使用
停车场栏杆过长，影响行人通行	质量和水平
外来车辆随意进入小区，希望物业加强管理	安全秩序没保障
投诉对物业服务态度及工作质量的不满	监控实施损坏
物业私涨停车费，局对此意见大	管理费
物业不公示收取账目问题	申请与使用
物业收取地暖清理费用过高，居民意见大	质量和水平
物业费太高的问题	物业费
协调物业解决家中配套设施不齐全的问题	日常服务不到位
希望帮助增设居委会	组织、推选
保安态度差	保安不当行为
了解哪个部门可以安装电动车充电桩	日常服务不到位
外来人口随意进出小区，希望加强管理	质量和水平
门卫不让进的问题	日常服务不到位
道路垃圾一直没有人清理/保密	垃圾清运费
消防通道做仓储项目不合理	安全秩序没保障
投诉中央戏剧学院雨儿胡同口处保安不当行为	保安不当行为
希望维修门禁门的问题	申请与使用
希望紧急启用公共维修基金	申请与使用
智能门无法使用	监控实施损坏
物业使用公共维修基金不合理	申请与使用
希望小区不让外来车辆进入/保密	安全秩序没保障
投诉商家买卖产品质量	入户维修态度及质量差
海淀区永泰东里社区服务站工作人员态度恶劣	威胁恐吓业主
频繁停电不合理	管理简单粗暴
希望物业明确出示维修预算资金【北京市委书记蔡奇】#人民网地方领导留言板#（待解释）	申请与使用
物业不作为	质量和水平
物业乱收费无资质“12315来电”	物业费
私自安装探头	安全秩序没保障
车辆乱停放	秩序混乱
顺天通物业公司安装、维修质量差问题	入户维修态度及质量差
小区不让进	质量和水平
 院内平房位置环境差	质量和水平
该公司未缴纳小区维修基金的问题	缴纳与监管
西湖新村小区收取楼道照明费	管理费
清逸西园小区没有保安	安全秩序没保障
物业公司强制要准运证和消纳证的问题	垃圾清运费
不发楼门钥匙的问题	态度与规范
孩童在停车场游戏存在隐患#微博#	安全没保障
通州区永顺镇镇政府物业科乱作为问题	权力运作及监督
街道办事处要求统一做外墙保温，至今没做	态度与规范
街道不帮助业主成立业主委员会	组织、推选
希望物业不公示物业费	物业费
物业费开发票物业收取业主税钱是否合理	物业费
业委会不作为	权力运作及监督
小区没有物业导致生活垃圾和建筑垃圾无人清理	组织、推选
物业租赁部长期把大量住宅房源租给公司办公不作为#市政府门户网站互动交流平台#	工作效率低
多收300元垃圾清理费不合理	垃圾清运费
建议增加隔离网	安全没保障
反映物业不让在地面停车不合理问题	态度与规范
物业收取停车费不合理	管理费
物业收费不合理	物业费
小区没有业委会，希望帮助成立	组织、推选
单元门禁损坏#评论#	安全秩序没保障
保安占用居民休息室的问题	保安不当行为
物业代收电费，且加收服务费，业主对此意见大	物业费
居民楼内违规开设幼儿园，希望查处	质量和水平
单元门门禁故障	质量和水平
大厦停车场迟迟未恢复问题	安全没保障
物业乱作为问题	质量和水平
物业强拆护栏不合理	管理简单粗暴
将台乡政府保安不让自己办理业务问题	保安不当行为
物业停车收费人员态度恶劣	管理费
物业费交费规定不合理的问题	物业费
投诉开发商不履行职责的问题	日常服务不到位
收取公共维修基金不合理问题	申请与使用
增设冲电动车的地方	日常服务不到位
主管道维修业主自己掏钱不合理	权力运作及监督
市民反映和平门小区停车场问题	管理简单粗暴
物业不作为	质量和水平
东湖街道办事处阻止小区成立业主委员会	受破坏及法律权益保障
物业工作效率低下	日常服务不到位
石景山区建委帮助核实只有产权车位是否需要缴纳公共维修基金#APP#	缴纳与监管
物业启动维护基金不合理	物业费
物业暂用a座入户大厅	管理简单粗暴
物业不作为问题/12319热线	质量和水平
天河众行物业状告业主却未通知业主问题#微博#	管理简单粗暴
摄像头故障的问题	监控实施损坏
反映物业私自涨物业费问题	态度与规范
希望增设车棚子	场地紧张
小区物业不退押金的问题	管理费
协调开发商公开车位价格信息	收费不合理
长期占用小区停车位进行二手车交易问题	秩序混乱
随意停放电动车	安全没保障
电表箱妨碍房门打不开的问题	管理简单粗暴
物业保安（宫春泼)骂人以及向自家泼尿的问题	保安不当行为
希望协调物业让自己带客户进去看房	工作效率低
物业给停电不合理的问题	管理简单粗暴
小区内停车安全没保障	安全没保障
中水费标准	管理费
小区物业收费不合理	物业费
小区维修消防希望物业出具维修消费清单	管理费
物业乱收费	物业费
业委会不往电力公司交钱	受破坏及法律权益保障
不给供暖	自供暖社区供暖费
小区保安态度不好要开除问题	保安不当行为
建议居委会在楼道内安装监控问题	安全没保障
协调筹备组会议安排到周末问题	组织、推选
东方瑞平家园乱收停车费问题#微博#	收费不合理
小区邮局信报箱门迟迟不维修的问题	日常服务不到位
电瓶车充值电发生危险	安全没保障
楼道长期不开灯	申请与使用
保安跨地区执法不合理	保安不当行为
小区物业办理临时出入证收费不合理	收费不合理
希望尽快成立业委会的问题	管理简单粗暴
单元门禁故障无人维修的问题	监控实施损坏
协调退押金	管理费
房本迟迟不发放问题	申请与使用
物业停车收费不合理	收费不合理
楼道灯故障的问题	质量和水平
天岳恒房屋管理有限公司@供暖费收费不合理”12319热线来电“	自供暖社区供暖费
西湖新村综合楼2单元存在私拉电线充电问题#微博#	安全秩序没保障
咨询物业收取装修押金是否合理问题	管理费
居委会代替居民召开业委会的问题	权力运作及监督
物业不作为	质量和水平
小区收取物业费不合理，希望查处	物业费
地下车库入口处有铁板导致过车有异响	安全没保障
物业私自换门禁卡	态度与规范
协调更换高清监控	监控实施损坏
投诉小区物业管理不当问题	入户维修态度及质量差
四季青镇常青园三区业委会主任发布虚假通知	权力运作及监督
希望增高铁栅栏并安装摄像头	安全秩序没保障
 收回花园不合理	申请与使用
单元门故障	日常服务不到位
希望尽快更换物业	管理简单粗暴
翡翠家园物业费收费不合理	物业费
小区内管理混乱问题	质量和水平
车位分配不合理	秩序混乱
停车收费不合理	收费不合理
加强治安管理问题/保密	安全秩序没保障
顺沙路八号院北二村小区地库入口堵塞#市政府门户网站互动交流平台#	管理简单粗暴
私自违法安装摄像头问题	监控实施损坏
青秀城小区被投毒存在安全隐患	安全秩序没保障
小区停车秩序差	秩序混乱
停车场出口不通行问题	安全没保障
没有参加选举被选举成为业委会委员问题	组织、推选
电梯费电费不合理	管理费
空调室外机外边的门是否归属于个人管理	态度与规范
物业费收费过高	物业费
推选的物业公司被工商拉入异常名录	组织、推选
希望将此处的绿化改为平地	管理简单粗暴
楼道和走廊内没有灯	日常服务不到位
楼道灯维修问题	入户维修态度及质量差
取消三项为老服务政策不合理	受破坏及法律权益保障
物业私自动用维修基金换电梯不合理	申请与使用
小区让外来车辆进入不合理	安全没保障
因小区内摄像头被施工方损坏不及时维修导致自家车辆被砸无人赔偿	安全没保障
物业乱收费的问题	管理费
投诉居委会发的通知如不不去签不同意意见书就视为同意	管理费
自家公共维修基金的使用情况	缴纳与监管
物业乱收费的问题	物业费
协调小区内更换360度旋转摄像头	态度与规范
物业收取商住两用房电费高，业主对此意见大	管理费
私接电线存在安全隐患的问题	工作效率低
无法清运渣土问题	垃圾清运费
楼道内停放电动车， 影响居民出行，希望尽快解决	秩序混乱
楼下停车不合理等的问题	安全没保障
希望物业退还停车管理费	管理费
要求隆盛园小区居民的电动车到小区西侧充电桩充电#APP#	安全秩序没保障
收取收取维修费	管理费
小区监控损坏	安全没保障
增设便民修车点	权力运作及监督
希望帮助核实收取建筑卫生处理费是否合理	垃圾清运费
小区停车秩序混乱，希望加强管理	质量和水平
小区不给安装门禁	监控实施损坏
炫特社区保安不当行为问题	保安不当行为
旧物业不做交接工作的问题	保安不当行为
停车占用消防通道/保密	安全没保障
房子地板返水迟迟没有解决	入户维修态度及质量差
希望西三旗街道办事处加强对保洁人员交通安全意识的培训	权力运作及监督
希望在郭公庄南街安装治安摄像头	监控实施损坏
地下井道	日常服务不到位
小区电梯停运的问题	入户维修态度及质量差
物业不让快递进小区	日常服务不到位
多余费用不退还以及摔倒后无人处理的问题	管理简单粗暴
物业未经业主同意，动用公共维修基金维修消防通道，居民对此意见大【北京市委书记蔡奇】#人民网地方领导留言板#	缴纳与监管
物业未按照通知提前停电问题	态度与规范
物业未按民用标准收取水电费/保密	收费不合理
金隅集团大成物业非法收取停车费	收费不合理
希望帮助了解一下住建委的审批是否合理	管理费
小区内侧门锁住不开出行不方便	日常服务不到位
物业收取装修管理费不合理	管理费
撤销诉求	安全没保障
希望小区进行封闭管理	安全秩序没保障
无人维修小区设备的问题	态度与规范
楼道内杂物物无人清理，影响通行	垃圾清运费
小区监控覆盖面积少以及损坏无人管#微博私信#	监控实施损坏
中铁五院保安私收停车费和损害业主车辆#市政府门户网站互动交流平台#	保安不当行为
工作人员骂人问题“12320热线来电”	态度与规范
物业私装地锁占用车位	态度与规范
物业收取物业费不合理	物业费
在小区内楼道里要有警力进行巡逻保护财产	安全秩序没保障
小区收费不合理的问题	管理费
物业多收取暖费	自供暖社区供暖费
尽快解决加装电梯问题	申请与使用
小区停车秩序差	秩序混乱
希望相关部门帮助核实加强玉带河西街30号楼的管理“12315热线来电”	管理简单粗暴
针对摄像头损坏的问题给自己一个说法	监控实施损坏
物业不让其他宽带进入小区不合理	日常服务不到位
物业不作为的问题	态度与规范
小区脏乱差的问题	工作效率低
停车秩序混乱	秩序混乱
协调小区重新申请业委会召开业主大会	组织、推选
燕海物业公司收取停车费未经过业主大会同意	收费不合理
龙建诚信物业威胁恐吓业主	威胁恐吓业主
限制水电缴费不合理	管理简单粗暴
物业不按照规定收费	管理费
市民反映增加安装摄像头的问题	监控实施损坏
帮助协调更换物业	态度与规范
物业雇佣大量黑保安	保安不当行为
希望将小区出售停车位价格公示	收费不合理
物业不让进小区	保安不当行为
物业收取水费不合理	物业费
侵占公摊面积	质量和水平
门禁故障问题	日常服务不到位
物业不让进小区不合理	保安不当行为
整治小区	态度与规范
希望马家堡街道给出相关的条例规定	组织、推选
物业乱收费	自供暖社区供暖费
来历不明的保安影响业主生活	日常服务不到位
小区电梯故障，希望尽快维修	态度与规范
投诉北京恒隆兴置业有限公司挪用公共维修基金	缴纳与监管
小区物业管理不到位	安全秩序没保障
物业收取停车费以及物业费都过高问题	物业费
中介乱扣押金的问题	管理费
小区电梯故障，影响居民出行，希望尽快维修	安全秩序没保障
汽车充电桩问题	申请与使用
街道不开放健身房和图书馆	日常服务不到位
希望相关部门尽快给小区组织业委会	组织、推选
摄像头不打开	监控实施损坏
物业不解决因为电压不稳重新布线问题	态度与规范
小区内落叶无人处理问题	日常服务不到位
物业乱收费	自供暖社区供暖费
石景山区古城街道古城小街5号院门3号楼1单元门禁故障	监控实施损坏
装修后垃圾无法清理，希望协调物业帮助清理	垃圾清运费
停车优惠政策要求不合理	收费不合理
停车场建造不合理	安全没保障
村保安服务态度不好	保安不当行为
地下室电梯口有人上厕所	日常服务不到位
 市民反映建设围挡不合理	安全秩序没保障
投诉小区物业不作为问题	工作效率低
东直门街道无原因收走锥桶问题	态度与规范
物业强制要求使用物业装修垃圾清运不合理	垃圾清运费
奥林匹克花园换届迟迟未推进#市政府门户网站互动交流平台#	组织、推选
物业不作为的问题	质量和水平
小区没有电动车设施建议增设	申请与使用
私占停车位导致其他居民无法正常停车的问题	秩序混乱
物业不作为	质量和水平
环卫工人收清理垃圾费不合理问题	垃圾清运费
小区监控损坏	监控实施损坏
双丰街道办事处审核业委会报名不合理	组织、推选
物业让保洁人员在早上清理垃圾不合理	态度与规范
投诉居委会收取停车费不合理	管理费
希望解决小区内卖臭肉影响正常生活问题	日常服务不到位
物业不制止业主不文明遛狗行为	日常服务不到位
物业乱收费	管理费
物业未经同意动用业主公共维修基金问题	申请与使用
水质量差问题	质量和水平
檀州家园小区物业不给安装充电桩	申请与使用
申请成立业委会	组织、推选
物业乱收费	物业费
物业公告业主个人信息，居民对此意见大	管理简单粗暴
小区内门禁故障，迟迟无人维修	安全秩序没保障
退物业费问题	物业费
物业公司不作为的问题#微博私信#	态度与规范
日常服务不到位	日常服务不到位
希望彻查本届天通苑业委会的合法性【北京市委书记蔡奇】#人民网地方领导留言板#/保密	权力运作及监督
窗户无法使用	入户维修态度及质量差
希望协调街道在小区内贴公示	权力运作及监督
公示业委会账户明细	缴纳与监管
申请成立业委会	组织、推选
韦伯豪家园停封小区地下停车场不合理	安全没保障
社会车辆进入自己小区不合理的问题	安全没保障
小区没有业主委员会，希望尽快成立	组织、推选
物业多收费问题	物业费
和义西里3区18号楼四周私装地锁	秩序混乱
机动车（充油）停在电动车车位上	秩序混乱
希望把坏围栏更换成门	日常服务不到位
投诉小区物业和孙河乡规划科	权力运作及监督
卢沟桥街道业务委员会内哄导致无人解决问题	权力运作及监督
业委会强行拆除宣传栏不合理	受破坏及法律权益保障
希望高井居委会尽快维修六千寺小区16号楼2单元的门禁	申请与使用
希望成立业委会	组织、推选
市民反映电线杆要倒问题	安全没保障
物业不让孩子在广场游玩问题	态度与规范
希望楼道大厅安装监控	监控实施损坏
小区物业管理人员态度差问题	保安不当行为
 小区物业乱收费的问题	物业费
未安装摄像头	监控实施损坏
门禁锁坏了	安全没保障
希望市建委对街道干预居民成立业委会进行彻查的问题	组织、推选
小区内未挂国旗问题	日常服务不到位
甜水园西里2号楼共享单车无故被搬走不合理问题	保安不当行为
协调退装修押金	物业费
核实大厦玻璃木墙离居民区的安全距离	安全秩序没保障
物业态度差	质量和水平
自己被威胁恐吓问题	威胁恐吓业主
 村内集体土地承包权未经村民同意被转让	管理费
开发商迟迟未上缴公共维修基金	缴纳与监管
物业不作为	入户维修态度及质量差
钱包丢失问题	权力运作及监督
物业乱收费	管理费
物业导致监控系统瘫痪的问题	监控实施损坏
希望协调在华普花园小区B座东南角安装监控器	监控实施损坏
物业服务不到位，高额收取物业费，业主维权难，希望更换新物业	物业费
撤销问题	管理费
黑物业强行收费的问题	管理费
停车管理费收费高	物业费
小区地库漏水#微博#	安全没保障
外来车辆随意进入小区无人管理的问题	秩序混乱
小区无人管理	日常服务不到位
电动车安全隐患的问题	安全秩序没保障
物业收费不合理	物业费
开发商未上交公共维修基金	缴纳与监管
物业把人行便道化成停车位不合理	秩序混乱
希望非本小区车辆不要进小区	工作效率低
废旧自行车占用车棚	秩序混乱
物业收费不合理	物业费
物业强制业主交楼道灯电费，居民对此意见大	管理费
物业不处理保安随地大小便的问题	日常服务不到位
星河湾小区物业公司中控主管及员工无证上岗/保密	质量和水平
希望镇政府协助居民成立业委会	组织、推选
投诉居委会服务态度问题	态度与规范
能对自家樱桃树被弄死的情况给个说法问题	日常服务不到位
楼道内做饭存在安全隐患问题	安全没保障
希望帮助核实更换自来水管道收费是否合理	管理费
小区监控设施少的问题	安全没保障
安全秩序没保障	安全秩序没保障
停车场不让停电动车	秩序混乱
物业不予清理药品垃圾。希望尽快处理	态度与规范
迟迟不同意成立业委会的问题	组织、推选
金荣园小区一期车辆被剐物业不管问题#微博#   	安全没保障
太阳能损坏无人维修问题	态度与规范
门口堆放垃圾	垃圾清运费
投诉物业不作为	质量和水平
小区业委会任期已满，迟迟未换届，希望更换业委会	组织、推选
楼道没有人扫楼道	入户维修态度及质量差
希望加强管理东四十一条31号院外来车辆随意进入问题#微博私信#	秩序混乱
居委会和物业不给开门牌号证明的问题	态度与规范
物业不给消防管道做保温问题	日常服务不到位
询问电梯故障的处理情况	安全秩序没保障
按照楼层高度收取供暖费不合理	自供暖社区供暖费
物业不作为	质量和水平
小区无人管理	秩序混乱
4s店开在住宅区不合理问题	安全秩序没保障
协调成立业委会	组织、推选
小区内违规建设出租屋	安全秩序没保障
物业不作为	入户维修态度及质量差
缴纳装修押金不合理	垃圾清运费
御路园小区私占停车位#市政府门户网站互动交流平台#	秩序混乱
物业管理问题/保密	管理简单粗暴
小区内脏乱差问题	日常服务不到位
希望政府帮助治理这种组织行为	组织、推选
小区物业违规动用维修基金	申请与使用
协调归还家具	日常服务不到位
物业不作为	管理简单粗暴
滴滴出行	申请与使用
不交停车费居民进入小区停车不合理问题	秩序混乱
物业收费不合理	物业费
帮助恢复小区所有摄像头功能	监控实施损坏
物业限购电量不合理	质量和水平
希望尽快成立业委会	组织、推选
恢复复兴北里小区东门原来门框	日常服务不到位
巩华新村小区保安私自锁车问题	保安不当行为
违章停车	秩序混乱
物业私自占用小区绿地建停车楼，小区居民意见大	安全没保障
希望督促换水泵	申请与使用
中控员无证上岗	保安不当行为
燃油车占用充电桩车位的问题	秩序混乱
市民反映协调快递车进出问题	入户维修态度及质量差
居民使用煤气罐有安全隐患的问题	安全秩序没保障
物业服务水平不佳，存在垃圾清理不及时、占用绿地修建停车场等问题，希望成立业委会进行维权	组织、推选
希望物业加强对小区内的安全管理	安全秩序没保障
物业收费不合理/保密	物业费
协调尽快维修监控	监控实施损坏
楼道照明灯不亮，居民晚间出行不便	工作效率低
物业不作为	质量和水平
协调有关部门协调把这个钥匙给小区居民分发一下	安全没保障
搬家收费不合理的问题	态度与规范
核实物业不让三轮车进入小区的原因	秩序混乱
小区物业未经业主同意私自动用维修基金问题	缴纳与监管
人行便道上乱停车影响出行的问题	秩序混乱
物业私自动用公共维修基金不合理问题	缴纳与监管
投诉物业工作不当	管理简单粗暴
物业不让居民车辆进入小区，居民对此意见大	管理简单粗暴
物业不履行职责	态度与规范
1楼是否用交电梯费	管理费
物业未入户维修客厅灯	入户维修态度及质量差
建议相关部门给安装电梯的问题	申请与使用
小区门禁改为人脸识别不合理	态度与规范
投诉物业不作为	日常服务不到位
永定路52号院一街坊小区监控损坏无人处理	安全没保障
亦庄经济开发区政府不让闫家场村外地人使用煤气罐做饭不合理	管理简单粗暴
物业长时间多收供暖费	自供暖社区供暖费
路侧停车小区不给办理停车位	场地紧张
建议改造外墙保温完成后将防盗窗还原	安全秩序没保障
协调物业退还多收的物业费	物业费
领取发票地址的不合理的问题	态度与规范
帮助核实小区管辖	保安不当行为
希望增加监控设施	监控实施损坏
物业日常服务不到位	日常服务不到位
不交物业费不给卖水问题	物业费
公共维修基金被挪用	缴纳与监管
门禁损坏无人维修	监控实施损坏
不希望小区成立业主委员会	组织、推选
小区两种物业收费方式不合理的问题	物业费
电投诉海开房地产公司滥用职权	管理简单粗暴
物业保安收取锁车费不合理	保安不当行为
投诉物业乱作为	质量和水平
物业收取停车费不合理的问题	管理简单粗暴
 反映单位不予缴纳维修基金	申请与使用
强占居民活动中心	态度与规范
外来车辆随意进出小区，存在安全隐患，希望加强管理	秩序混乱
环卫洒水车不看人的问题	态度与规范
希望本中心传达办事处指挥中心给自己提供反映的问题和回复内容以便起诉	管理简单粗暴
小区行人进出道路太窄	安全没保障
物业收取门禁卡押金不合理问	物业费
物业公司不给开收据	入户维修态度及质量差
地上车库被违规出租住人，希望查处	安全没保障
阿凡骑公司私自撬开小区南门问题	安全没保障
物业频繁骚扰住户问题	威胁恐吓业主
物业不作为的问题	质量和水平
物业不作为	入户维修态度及质量差
小区第三方不让业主进小区	保安不当行为
停车费收取不合理	物业费
被居委会候炳菊主任家属威胁问题	威胁恐吓业主
暴露垃圾一直无人处理	日常服务不到位
湖北小区没有物业和居委会管理	日常服务不到位
收费过高不合理	收费不合理
希望帮助协调在小区楼道内安装监控	监控实施损坏
碣石坪15号楼业委会强制破拆道路围墙的问题#微博#	权力运作及监督
格林莱雅小区物业不作为【北京市委书记蔡奇】#人民网地方领导留言板#	入户维修态度及质量差
物业收取装修垃圾清运费不合理的问题	垃圾清运费
希望协调尽快成立业委会	组织、推选
充电桩位置安装不合理的问题	安全没保障
村委会要求村民安装人脸识别机器，并收取物业管理费，村民认为不合理“12319热线来电” 	管理简单粗暴
物业未经业主同意私自安装门禁，居民对此意见大	管理简单粗暴
希望将小区分区	保安不当行为
物业不作为问题	质量和水平
物业私自在11号楼楼下动工盖楼问题	入户维修态度及质量差
协调小区物业粉刷墙上小广告的问题	日常服务不到位
供电局保安在永乐小区赌博	保安不当行为
投诉物业车位收费不合理问题	管理费
物业费收取价格不合理	物业费
物业不作为	工作效率低
和谐家园二区物业管理不善	日常服务不到位
加强小区摄像头维护及加装问题	监控实施损坏
充电桩收费不合理	物业费
希望小区物业对外来车辆停放加强管理	质量和水平
物业收费不合理	管理费
小区监控设施损坏	监控实施损坏
决垃圾随意堆放	垃圾清运费
小区传达室变为保安宿舍	保安不当行为
物业不作为	管理简单粗暴
水云居小区绿地被保安使用警戒线围住不合理问题	管理简单粗暴
物业不给业主花名册的问题	权力运作及监督
希望相关部门协调业主重新改选	权力运作及监督
协调维修树木	监控实施损坏
物业动用公共维修基金问题#微博#	申请与使用
物业代收电费，且收费价格高，业主对此意见大	管理费
住户私改管道	日常服务不到位
希望安排人员把洞口给堵死	日常服务不到位
树枝占用停车位	安全没保障
投诉物业日常服务不到位	日常服务不到位
东城区东直门街道东湖别墅不让穿行不合理	保安不当行为
业委会选举流程不合规	组织、推选
希望把小区内设施尽快恢复原状	监控实施损坏
保安室私拉电线	保安不当行为
物业态度恶劣不让停车	态度与规范
小区没有自行车停放处	秩序混乱
楼道内路灯没灯泡和不亮	日常服务不到位
希望自己家恢复原状	管理简单粗暴
物业威胁恐吓业主的问题	威胁恐吓业主
加强高空抛物排查问题	安全秩序没保障
新物业收费不合理	管理费
充电桩车位被汽油车占用无法充电问题	日常服务不到位
投诉物业	入户维修态度及质量差
收取的垃圾费不合理	垃圾清运费
执法队员态度恶劣	态度与规范
 希望及时修理监控设施	监控实施损坏
建筑垃圾长期堆放，希望尽快清理	日常服务不到位
自己不希望小区安装门禁	申请与使用
投诉物业私自租售小区公共停车位问题	管理简单粗暴
物业不退自己公共维修基金	申请与使用
希望物业让自己开空调问题	质量和水平
帮助核实电动车反光镜怎么坏的问题	日常服务不到位
解决市民成立业委会的问题	组织、推选
确定小区归属地	组织、推选
协调安装监控问题	监控实施损坏
业委会选举程序不规范	组织、推选
希望职能部门修理监控	监控实施损坏
希望尽快给自己报销维修费用问题	管理费
首发多收费问题并给出行政复议答复不合理	收费不合理
协调小区保安加强巡逻	保安不当行为
建议增设摄像头问题	监控实施损坏
物业工作做不到位问题	日常服务不到位
钧豪物业随意停电	管理简单粗暴
物业不处理抢占车位	秩序混乱
商务性公寓都在退公共维修基金，富力未按照规定退还	缴纳与监管
投诉物业服务差	安全秩序没保障
市民反映物业态度服务差的问题	态度与规范
开发商侵吞公款问题	缴纳与监管
小区物业无故断电导致健身馆损失严重	威胁恐吓业主
建议加强小区停车管理	安全没保障
物业不作为	管理简单粗暴
物业装修押金不退	管理费
丽园小区增设监控设施问题	监控实施损坏
金色满香郡小区物业收取垃圾费用不合理	垃圾清运费
投诉中通快递	态度与规范
物业保安态度恶劣	保安不当行为
映溪城家园东区12号楼703室尸臭影响其他业主正常生活	入户维修态度及质量差
让交全部物业费不合理的问题	物业费
物业不作为	质量和水平
小区物业费违法乱涨价不合理	物业费
希望街道办事处接收小区	态度与规范
协调清除楼道内异味问题	日常服务不到位
因家庭装修导致居民家的墙体开裂无人管	质量和水平
香悦四季小区未购买车位的车辆禁止进入小区不合理问题	态度与规范
小区安保不到位问题“12315热线来电”	安全秩序没保障
摄像头损坏无人维修	监控实施损坏
投诉物业服务态度不好	态度与规范
小区单元门门禁系统安装不合理	入户维修态度及质量差
建议物业加强对小区管理	日常服务不到位
小区物业未入户维修其家客厅灯	入户维修态度及质量差
协调尽快做变更	质量和水平
协调居委会帮助挂光荣之家的牌子	态度与规范
物业不作为	物业费
希望尽快清理楼道小广告	态度与规范
投诉负责弘善家园403号楼底商的物业公司	质量和水平
拆除防盗窗不合理	安全秩序没保障
希望物业尽快为市民家更改房主名字	态度与规范
小区物业多收停车费	收费不合理
物业说房租不能交银行	管理简单粗暴
在中晟馨苑小区开启电动自行车充电桩或者盖车棚	安全没保障
投诉物业公司乱收费的问题	物业费
自家装修后拆除的旧设施需要清运，瑞斯特物业管理有限公司并向自己收取费用，自己认为不合理	垃圾清运费
2号楼院内道路不平、私装地锁问题	申请与使用
小区的安全秩序没有保障	安全秩序没保障
顺义区仁和镇和仓上居委会非法使用公章	权力运作及监督
海悦城小区C区C536室房间灯池以及走廊很多耗子	日常服务不到位
绿湾星苑小区无法使用太阳能	日常服务不到位
业主在屋内充电存在安全隐患	安全秩序没保障
尽快修理东门	安全秩序没保障
居委会欺上,浪费社会资源不合理	权力运作及监督
物业公司多收费"12315热线来电"	管理费
小区改造供热管道，导致居民无处停车，希望增设临时停车场	场地紧张
物业迟迟未退还装修押金问题	垃圾清运费
龙华园东区小区监控设施问题#微博私信#	监控实施损坏
了解收费是否合理	管理费
 卫生间渗水物业迟迟不给维修的问题	态度与规范
小区内高空抛物	安全没保障
 街道不帮助业主成立业主委员会	组织、推选
办理门禁卡收费	管理费
华润首开华润城物业与开发商透露公民信息诱发业主间矛盾问题#微博#   	质量和水平
物业未入户维修客厅灯	入户维修态度及质量差
希望相关部门协助清理小区保安问题	保安不当行为
新华联慧谷小区物业管理不规范问题【北京市委书记蔡奇】#领导留言板#	态度与规范
空调室外机的架子损坏无人维修的问题	质量和水平
投诉开发商融创地产不给自家修空调	入户维修态度及质量差
供暖费谁给报问题	自供暖社区供暖费
希望尽快恢复车棚子	安全没保障
加强管理车辆停放	秩序混乱
小区出售桶装水不合理问题	管理费
水色时光五区迟迟无法成立业主委员会	组织、推选
开发商售卖房屋存在问题不处理	入户维修态度及质量差
新能源汽车无处充电，希望增设充电桩	态度与规范
使用专项维修金不合理	申请与使用
市民反映物业不让快递员进的问题	保安不当行为
管庄办事处阻止小区成立业委会不合理	组织、推选
帮助协调动用公共基金维修空调	申请与使用
因部分业主未缴纳公共维修基金，导致物业不给做防水修缮，希望协调解决	缴纳与监管
协调搭建车棚问题	安全没保障
物业未经业主乱用公共维修基金	管理简单粗暴
燕语华庭小区物业私自掐断快递箱子电问题	管理简单粗暴
物业临时更改停车缴费政策没公示问题	秩序混乱
物业管理不当	工作效率低
业委会影响居民生活/保密	权力运作及监督
空调漏水无人管理的问题	管理简单粗暴
未安装门禁问题	安全没保障
小区内多处监控故障	监控实施损坏
房屋漏水物业迟迟不帮助维修	日常服务不到位
物业收取开门服务费不合理/保密	态度与规范
 玉树临风小区成立业委会问题	组织、推选
申请清欣园小区北京业主app	权力运作及监督
林校北里不让安装充电桩	申请与使用
协调安装充电桩问题	态度与规范
建停车位安全问题	日常服务不到位
小区监控损坏问题	监控实施损坏
物业管理不合格	管理简单粗暴
用铁链子占车位不合理	秩序混乱
物业收取滞纳金不合理	物业费
物业不给处理保安不让自己出去问题	保安不当行为
物业不作为，粗暴管理	管理简单粗暴
政府用车占停车位	安全没保障
安全门升级改造施工未完成	监控实施损坏
投诉开发商融创地产不给自家修空调	入户维修态度及质量差
物业强制无法进入联通宽带问题/保密	管理简单粗暴
设备老化的问题，影响居民出行，希望尽快协调维修	安全没保障
协调物业退还公共维修基金	缴纳与监管
物业乱收费	管理费
小区内僵尸车占车位，希望清理	秩序混乱
希望核实物业收费标准	物业费
北京沃邦物业管理有限公司多收垃圾清运费问题	垃圾清运费
业委会拒绝开业主大会的问题	组织、推选
建议15区停车库不要停放电动汽车	安全没保障
花盆影响通行	日常服务不到位
鸿博家园二期D区物业不履职	安全没保障
未按规定进行业务会选举/保密	组织、推选
宽带垄断#微博#	态度与规范
车辆被划无人管理	监控实施损坏
了解小区归属哪个居委会管理	权力运作及监督
中海紫金苑小区保安缺乏管理	保安不当行为
频繁更换停车公司	安全没保障
物业长期占用小区活动用房和设备间	安全没保障
物业乱收费的问题	管理费
车辆被树木砸坏物业不去处理(大风）	安全秩序没保障
物业刁难业主影响装修进度“12319热线来电”	态度与规范
树枝被大风刮折砸到自己车无人赔偿	安全没保障
物业收取高价物业费，业主对此意见大	物业费
房山区供电所否绝安装充电桩不合理	质量和水平
建设地下停车场不合理	安全没保障
物业私自涨物业费问题	物业费
物业不作为	质量和水平
投诉东湖街道办事处阻挠市民不让成立业主委员会	组织、推选
修理监控设施	监控实施损坏
小区内迟迟无法成立业主委员会	组织、推选
投诉物业服务态度与质量问题	管理简单粗暴
希望尽快给小区增设安装监控摄像头	监控实施损坏
收停车费不合理	收费不合理
业委会候选人未公示不合理	权力运作及监督
小区保安队长态度恶劣骂人问题	保安不当行为
物业故意停电梯	质量和水平
物业不管理小区	质量和水平
物业不让装充电桩	态度与规范
小区管理混乱	管理简单粗暴
投诉物业不作为	质量和水平
植德律师事务所尽快按照程序办理相关事宜	权力运作及监督
物业收取电费违约金，居民对此意见大	管理费
物业不配合成立业委会，希望协调解决	受破坏及法律权益保障
长期占用停车位/保密	秩序混乱
希望帮助核实了解是否是社区清走的自行车问题	管理简单粗暴
保温段小区监控设备损坏问题#微博私信#	监控实施损坏
清乐园小区现存问题#微博私信#	受破坏及法律权益保障
小区西门不开放，影响居民出行	管理简单粗暴
停车堵住消防通道	安全没保障
核实收取垃圾清运费是否合理问题	垃圾清运费
物业收费不合理	管理费
希望归还业主公共停车位	收费不合理
希望物业帮助处理房屋发霉问题	质量和水平
热水器故障物业不给维修的问题	态度与规范
居委会未监督物业不管理好外来车辆进入出#市政府门户网站互动交流平台#	安全秩序没保障
失效的时间不合理	收费不合理
小区防盗门修缮	入户维修态度及质量差
楼门质量问题	入户维修态度及质量差
小区门禁无人管理	安全秩序没保障
小区垃圾分类问题	垃圾清运费
尽快成立业委会问题（领导接听）	组织、推选
连兴街2号院中奥嘉园一期没有启用监控【北京市委书记蔡奇】#领导留言板#	监控实施损坏
因装修被物业收取高额费用#微博私信#	垃圾清运费
房屋漏水物业迟迟不帮助维修	日常服务不到位
物业没有按照一户多人口新规定卖电	管理费
未经业主同意私自更换门禁系统，强行要求居民下载APP软件，居民对此意见大	管理简单粗暴
小区下水管道堵塞物业不帮助处理	质量和水平
北京市保障性住房建设投资中心@监控设施缺乏	监控实施损坏
外墙悬挂大型设备不合理	日常服务不到位
开发商按照建筑面积收取装修垃圾清理费不合理问题	垃圾清运费
市民反映希望公司补齐帮助缴纳社保	缴纳与监管
物业工作方法非常不得当	管理简单粗暴
核实协调退回多缴纳的费用的问题	物业费
投诉物业工作人员服务态度不好	态度与规范
挪车问题	秩序混乱
物业迟迟不给修门禁	日常服务不到位
希望协商物业退押金	物业费
物业不处理漏水	入户维修态度及质量差
未经业主同意，物业私自动用公共维修基金，业主对此意见大	申请与使用
物业费收费不合理	物业费
小区监控损坏问题	监控实施损坏
小区停车秩序差	秩序混乱
居委会管理不严格的问题/保密	安全秩序没保障
育新创景物业管理公司高额收取供暖费不合理/保密	管理费
海淀交通支队保安不让自己进入海淀交通支队	保安不当行为
街道私自出租小区停车位	安全没保障
电梯口没有安装瓷砖的问题	质量和水平
希望协调出租停车位	收费不合理
阻车杆故障无人维修	安全没保障
希望协调退卡	管理费
小区不让车辆下地库	场地紧张
小区停放僵尸车，导致周边居民停车不便，希望清理	秩序混乱
物业不退多交的费用问题	物业费
物业收费不合理问题/保密	管理费
开发商给业委会办公室贴封条不合理	受破坏及法律权益保障
物业收费不合理“12315热线来电”	管理费
小区门禁广告吓人无人管理问题	安全秩序没保障
青秀城公租房地砖损坏	入户维修态度及质量差
物业多收费	管理费
物业费价格的咨询	物业费
韩庄子三里小区有人高空坠物存在安全隐患	日常服务不到位
台阶私自磨成坡的问题	申请与使用
居委会和物业拿走市民在楼道放的东西	管理简单粗暴
协调安装监控	安全秩序没保障
不给琳琅庄园小区内居民发放噪音费问题	管理费
物业不作为导致业主出行不便	安全没保障
物业停车收费不合理	管理费
排油烟不合格的问题	质量和水平
小区物业收取费用未出示相关文件	管理费
乱收费	垃圾清运费
7辆电动车一起充电存在安全隐患	安全没保障
彩虹新城小区物业不作为#市政府门户网站互动交流平台#	管理简单粗暴
物业没有给退房款	管理费
物业收取电梯费和水泵费不合理	管理费
小区物业干扰业委会选举	受破坏及法律权益保障
建议推选业委会	组织、推选
协调大厦供冷问题#微博私信#	质量和水平
物业收费不合理问题	物业费
绿地改成停车场收不收费	收费不合理
物业不作为的问题。	管理费
物业保安队队长养狗存在安全隐患	安全秩序没保障
双桥北内小区胡同往南出行的道路被堵造成居民出行困难	日常服务不到位
协调物业推进小区安装充电桩问题	质量和水平
物业费过高不合理	物业费
投诉紫金新园2区让业主缴纳基础设施费不合理问题	管理费
自家水表故障迟迟无人维修，影响居民用水	质量和水平
投诉物业不作为问题	态度与规范
小区内停车收费符不符合相关规定	收费不合理
老业委会不做交接	组织、推选
物业收取商住两用房电费高	物业费
物业收门禁卡费用不合理问题	管理费
物业收费（进场服务费）不合理	态度与规范
核实了解一下此保安是否是物业公司的保安	保安不当行为
选举业委会的方式不合理	受破坏及法律权益保障
 建议加设监控探头	监控实施损坏
兴海园物业乱收费	态度与规范
汤泉墅小区停车秩序差问题	秩序混乱
办理业主委员会问题	组织、推选
安装栏杆不合理的问题	质量和水平
小区热水价格过高	物业费
开发商收费不合理	管理费
小区保安不让车辆从南门过的问题	保安不当行为
希望尽快更换摄像头	监控实施损坏
物业收取大件垃圾清理费不合理	垃圾清运费
投诉国贸万达物业	安全没保障
希望尽快把狗屎清理	日常服务不到位
紫金新园二区5号楼19层楼道灯不亮了	入户维修态度及质量差
私自涨停车费和安装电梯费用业主全额出不合理	安全没保障
电梯问题	缴纳与监管
保安不让外卖和快递车辆进来	保安不当行为
乘坐电梯收费不合理问题	管理费
资料已经上交但业委会迟迟没有成立	组织、推选
物业不予提供服务	物业费
物业管理制度不完善问题	日常服务不到位
核实了解生活垃圾处理费和卫生费是不是一项	垃圾清运费
协调退款	缴纳与监管
业委会主任辞职不做交接	权力运作及监督
小区没有安保措施	安全秩序没保障
玉树临风小区成立业委会	组织、推选
物业服务质量差	管理简单粗暴
物业不受业委会监管问题	权力运作及监督
开发商与相关部门回复的结果不一样	质量和水平
 物业收费不合理	物业费
小区没有保安问题	安全秩序没保障
小区物业收取垃圾清运费按照建筑面积每平米45元是否合理问题	垃圾清运费
物业收取管理费不合理	管理费
协调加强管理小区内拉电线给电动车充电的问题	安全秩序没保障
小区物业不作为	态度与规范
业委会和物业勾结不让小区居民从新改选业委会	组织、推选
垃圾堆放现象	垃圾清运费
活动中心未开放问题	组织、推选
地下车库配套设施不足不符合使用条件存在安全隐患“12350热线来电”	安全没保障
物业不给退费的问题	入户维修态度及质量差
公共停车场被上锁	秩序混乱
物业收取物业费不合理	管理费
建议物业整改车位规划	安全没保障
希望清洁工及时打扫小区狗屎问题	日常服务不到位
车库地面返水问题	安全没保障
违建拆除破坏自己房屋	受破坏及法律权益保障
让工人办理出入证不合理	态度与规范
小区监控没有打开的问题	监控实施损坏
小区内治安存在安全隐患	安全秩序没保障
街道不处理业委会人员缺少问题	权力运作及监督
物业锁车不合理	态度与规范
投诉房地产开发商阻止新物业开展工作	管理简单粗暴
社区自行把公共绿地改成收费停车场	入户维修态度及质量差
物业不给处理保安不让自己出去	保安不当行为
小区楼道内消防设施不完善问题	保安不当行为
撤销投诉	申请与使用
因各部门不配合祈东家园小区二期成立业主委员会导致小区居民要跳楼	组织、推选
私自强拆西墙和事后如何恢复	安全秩序没保障
希望物业及时更换小区外墙损坏以及不清晰摄像头/保密	监控实施损坏
楼梯间消防通道被堵，影响通行	安全秩序没保障
业主委员会备案迟迟没有结果问题	权力运作及监督
私自动用公用维修基金不合理问题	缴纳与监管
北京乡村高尔夫别墅小区围墙未遮挡	安全秩序没保障
物业不进行赔偿	安全没保障
业委会私发短信	组织、推选
小区里监控实施损坏无人修复	监控实施损坏
市民反映新物业无法入驻的问题	组织、推选
底商使用塑料鲜花包装外墙存在很大安全隐患问题	安全秩序没保障
物业收费不公示明细的问题	物业费
恢复充电桩使用	日常服务不到位
11号楼监控数量少并且使用不规范问题#今日头条私信#	质量和水平
物业不作为	态度与规范
城建集团兴华地产有限公司服务态度和水平差	态度与规范
物业服务存在着非常恶劣的态度	态度与规范
外来车辆进入小区停车不合理	安全没保障
希望小区继续可以双向进出	质量和水平
房顶漏水物业收维费	物业费
没有发卫生管理费的问题	管理费
私自把小区绿地改成停车场进行收费	安全没保障
安全隐患	安全没保障
小区大门门禁无人维修	安全秩序没保障
保安不让从东、西进入小区问题	日常服务不到位
物业收取停车费不合理的问题	收费不合理
公共下水管道经常堵塞，物业针对性收费不合理	管理费
建委迟迟不批维修资金	申请与使用
小区业委会乱作为的问题	权力运作及监督
物业收费不合理的问题	管理费
天威物业保安不让进	保安不当行为
投诉物业威胁恐吓业主	威胁恐吓业主
物业施工单位在雨天做防水质量得不到保障	安全秩序没保障
物业私自停水停电	质量和水平
核实阿尔法西区物业收取物业费扣除税费是否合理	物业费
物业不作为的问题	威胁恐吓业主
希望海开依规把地下车库维修好并且移交给业委会	安全没保障
外来物业强行进住小区	威胁恐吓业主
小区电动车充电 #市政府门户网站互动交流平台#	安全秩序没保障
法院强制管理停车位使用不合理	安全没保障
物业私改会所用途不合理	管理简单粗暴
希望硬化地面	态度与规范
未进行垃圾分类问题	管理简单粗暴
希望增设老年活动中心	组织、推选
房屋漏雨，影响居住，希望尽快修缮	申请与使用
物业乱收费	管理费
停车管理公司限制业主开车进出小区问题	收费不合理
西沿头村监控损坏	监控实施损坏
小区内安保无保障	安全秩序没保障
外来人口管理站私自锁车收费	管理费
投诉物业乱作为	态度与规范
私自占用车位	安全没保障
改成声控灯不合理	日常服务不到位
公房出租引发的问题	质量和水平
小区不让进车问题	安全没保障
单元门禁损坏#评论#	缴纳与监管
希望组织居委会/保密	组织、推选
希望成立业主委员会	组织、推选
中关村西区管委会不允许新租户进来不合理	管理简单粗暴
小区停车秩序差及私装地锁	秩序混乱
路劲物业动用住户的公共维修金不合理	申请与使用
物业不给市民电卡问题	质量和水平
物业收取合闸费不合理的问题	物业费
小区内环境脏乱和小区门未开放	态度与规范
水磨社区健身器材处停放电动车不合理	秩序混乱
小区内脏乱差无人处理	日常服务不到位
物业工作简单粗暴，让车辆出小区	管理简单粗暴
物业工作人员态度差	质量和水平
监控迟迟不维修	监控实施损坏
胜古北里26号院内安保#市政府门户网站互动交流平台#	安全秩序没保障
物业私自锁车不合理	质量和水平
家委会人员上任不合理	权力运作及监督
上交业委会成立材料未回复的问题	组织、推选
地下车库无人清理	日常服务不到位
投诉物业严重失职	监控实施损坏
物业不让自己交电费的问题	态度与规范
物业不作为	质量和水平
不给充值电费问题	管理简单粗暴
电梯故障无人修理问题	申请与使用
物业供销社职工闹事	安全秩序没保障
物业不处理路面低洼不平导致积水	入户维修态度及质量差
安河家园六里小区绿化无人养护问题#微博私信#	态度与规范
居委会私下操作APP影响业委会改选	受破坏及法律权益保障
小区业委会改选	组织、推选
如何创建银行账号	组织、推选
物业私自更换电表不合理	态度与规范
物业监控和安保工作不到位	监控实施损坏
投诉东升园公寓物业	管理简单粗暴
不花钱办卡	管理费
投诉东旭佳业迟迟不给业主解决车位	日常服务不到位
物业非法锁车	管理简单粗暴
物业收取垃圾处理费不合理问题	垃圾清运费
物业收费不合理	物业费
协调更改停车收费政策	收费不合理
物业乱收电费	物业费
业委会出席14：00点的座谈会的问题	权力运作及监督
希望移走苹果园三区6号楼楼下石头问题	安全秩序没保障
小区物业收管理费不合理	管理费
民用楼安装摄像头不合理	监控实施损坏
小区停车秩序混乱	秩序混乱
物业上涨物业费不合理	物业费
希望有关部门修复水池支架问题	质量和水平
希望物业尽快申请公共维修基金后对美然动力街区3号楼楼顶进行维修	申请与使用
自家房子被淹无人处理	质量和水平
协调镇里尽快给小区入驻物业问题	安全秩序没保障
咨询如何提取公共维修基金	申请与使用
物业管理规定对物业的约束力	质量和水平
房子没有住还需要交物业费的问题	管理费
咨询供暖费	自供暖社区供暖费
选举物业开发商串标#微博# 	受破坏及法律权益保障
小区无保安问题#市政府门户网站互动交流平台#	日常服务不到位
投诉西革新里保安不作为	保安不当行为
建议增加模式口北里39和40号楼大门门禁并安装摄像头#微博#	安全秩序没保障
物业不让快递员进入小区送货	日常服务不到位
协调劲松街道监控中心尽快查看监控问题	监控实施损坏
希望物业公示使用物业基金的问题	申请与使用
楼道内无人打扫问题	日常服务不到位
小区未成立业委会，希望尽快组建	组织、推选
物业私自涨停车费未经业主同意	收费不合理
水管被开发商挖开修后不给填上	入户维修态度及质量差
六合新村3号楼物业不作为	日常服务不到位
物业没有任何通知私自清理东西不合理问题	管理简单粗暴
物业私自涨物业费	物业费
物业出售人房车库不合理	缴纳与监管
房山新建巷修造厂八区小区治安有隐患问题#市政府门户网站互动交流平台#	安全秩序没保障
石墩子未清理	入户维修态度及质量差
街道阻挠小区成立业委会	日常服务不到位
帮助协调更换小区保安	安全秩序没保障
龙湖地产物业私自断水电问题	态度与规范
万年花城小区楼道堆放杂物、万年花城小区楼道抽烟问题#评论#	日常服务不到位
北京天和盛京物业管理有限公司乱作为问题	威胁恐吓业主
私自拉线进行充电	安全没保障
开放路117号摄像头不运转的问题	监控实施损坏
咨询保安招聘条件	保安不当行为
物业不受业委会监管问题	权力运作及监督
霄云路霞光里30号院存在私装地锁现象#微博私信#	秩序混乱
来电投诉物业不作为的问题	安全没保障
尽快收回公共活动区域办理活动场所的问题/保密	态度与规范
物业收地下车库管理费是否合理	管理费
中弘北京像素小区没有监控设施	监控实施损坏
物业迟迟不给维修压力阀	入户维修态度及质量差
保安职责问题	保安不当行为
小区内监控未投入使用，希望尽快解决	监控实施损坏
租户没有停车位	安全没保障
交公共维修基金不合理	缴纳与监管
核实小区内装修垃圾清运的收费标准“12358热线来电”	垃圾清运费
小区物业保安态度恶劣的问题	态度与规范
老物业拖延交接问题	权力运作及监督
物业不作为	管理简单粗暴
楼道灯不亮无人处理问题	日常服务不到位
物业收费相关问题	物业费
东旭家业保安说话不礼貌	保安不当行为
希望有关部门帮助换锁	管理简单粗暴
莱圳家园小区业主管理的公共收益资金一直被物业非法侵占#APP#	组织、推选
切断晾衣绳不合理	质量和水平
无法安装充电桩的问题	日常服务不到位
物业使用公共维修基金金额不合理的问题	申请与使用
安保不到位	安全秩序没保障
物业乱收费	物业费
天通苑西三区32号楼东侧围墙的栏杆破裂无人维修	质量和水平
反映物业收取物业费不给物业合同不合理	物业费
建议建设公共电动车充电车棚	安全没保障
物业无故不让快递进小区的问题	日常服务不到位
希望核实物业乱收物业费问题	物业费
物业威胁市民、私装地锁	态度与规范
小区环境脏乱差无人管理	日常服务不到位
甘露园南里一社区居委会不处理私占车位的问题不作为	秩序混乱
 电梯故障影响出行，希望尽快维修	申请与使用
投诉民警保安服务态度差	态度与规范
建外大街16号东方瑞景小区没有门禁	安全秩序没保障
物业不给开中央空调问题	态度与规范
因物业强制断电对自己造成损失要求赔偿	管理费
社区没有通知到位导致业主分不到车位	权力运作及监督
核实补缴物业费是否合理	物业费
小区内存在安全隐患	管理简单粗暴
小区内道路积雪无人清扫	态度与规范
物业管理人员服务差	态度与规范
希望加强对捡废品的管理	日常服务不到位
怡馨家园一区监控模糊无法保证安全	监控实施损坏
小区监控损坏	监控实施损坏
树木倾斜有倾倒隐患，希望及时处理	日常服务不到位
动用维修基金没有经过正常手续公开	缴纳与监管
非法建造隔离墙	态度与规范
政府可以成立一个网上平台进行投票	权力运作及监督
协调物业尽快清理垃圾	质量和水平
小区停车位没有监控的问题	监控实施损坏
投诉商城安保人员	保安不当行为
物业不履行职责问题	态度与规范
反映收到短信威胁、恐吓问题	威胁恐吓业主
小区内乱停车问题	秩序混乱
未经业主同意上涨价车位租赁费，业主对此意见大“12315热线来电”	收费不合理
希望协调在敬老院内多增设保安的问题	安全秩序没保障
小区保安违法查看居民身份证的问题	保安不当行为
小区环境脏乱差	日常服务不到位
居委会改选没有选择名字程序不合理	组织、推选
物业规划停车位不合理的问题	安全没保障
业委会不进行财务账目信息公开	权力运作及监督
未经业主同意私自引进新物业，业主对此意见大	权力运作及监督
保安态度恶劣的问题/保密	保安不当行为
小区环境差【北京市委书记蔡奇】#人民网地方领导留言板#	质量和水平
 暂用地下停车位开店	安全没保障
单元楼防盗门损坏，迟迟无人维修	安全秩序没保障
无法办理车证不合理	安全没保障
物业擅自动用公共维修基金	申请与使用
小区物业不做为问题	质量和水平
物业收取费用不合理	物业费
未经业主同意业委会擅自用公共维修基金	权力运作及监督
物业工作效率低下	日常服务不到位
清河街道办事处乱作为	权力运作及监督
首座御园1期小区物业不作为	日常服务不到位
小区安全没保障	安全秩序没保障
物业不让进车不合理问题	保安不当行为
物业私拉电线	日常服务不到位
物业费过高不合理	物业费
协议尽快修缮小区的管子	质量和水平
小区内狗乱窜存在安全隐患	日常服务不到位
业主未租赁停车位物业不让车辆进入	秩序混乱
投诉物业不作为	质量和水平
复兴北里22号楼7单元无保安	保安不当行为
物业不作为的问题	质量和水平
物业办事效率差不作为	工作效率低
物业不作为	质量和水平
“12315热线来电”	态度与规范
对保安的倾诉	保安不当行为
 物业无故不让自己车辆进入小区不合理	态度与规范
业委会延迟交接影响小区管理的问题	权力运作及监督
协调清走保安	保安不当行为
小区停车管理费收费不合理	管理费
小南庄小区的问题	安全秩序没保障
希望小区能封闭式管理	安全秩序没保障
物业收费不合理问题	管理费
小区地下停车场未开放	场地紧张
汽车乱停放导致充电桩无法使用问题	秩序混乱
建设停车场不合理	秩序混乱
楼道声控灯故障，希望尽快维修	态度与规范
小区居委会不同意改选业委会不合理问题	组织、推选
门禁损坏无人维修	安全秩序没保障
小区设置保安不得当	保安不当行为
物业使用公共维修基金维修房顶报价高，且未进行公示具体明细，业主对此意见大	申请与使用
小区没有进行网格管理	日常服务不到位
小区没有物业管理	质量和水平
物业不给处理保安不让自己出去的问题	保安不当行为
小区存在100多户小产权房屋,因房屋存在争议，属于一房二卖,多次经过法院判决，判决现房主享有居住权，但物业依然强行继水电，影响居民正常生活	管理简单粗暴
小区监控损坏无法修理问题	监控实施损坏
小区业委会成立	组织、推选
物业不作为	质量和水平
物业私自出租高层房屋存在安全隐患	安全秩序没保障
莱圳家园小区业主管理的公共收益资金一直被物业非法侵占#APP#	权力运作及监督
物业不让在地下车库停车不合理	质量和水平
小区物业监控损坏无人修理不合理的问题	保安不当行为
停车位压到消防井有安全隐患的问题	安全没保障
居委会私自开设小门不合理	日常服务不到位
楼道里玩牌扰民	日常服务不到位
物业私自动用维修基金	申请与使用
小区内停车秩序管理混乱的问题【北京市委书记蔡奇】#人民网地方领导留言板#	秩序混乱
树木拥挤导致房屋开裂.	保安不当行为
物业收费不合理	物业费
物业不作为	态度与规范
希望南海雅苑小区附近增设停车场	收费不合理
投诉北京牡丹风情物业管理有限公司管理不当	态度与规范
开阳5区北门停放金杯车堵路问题	秩序混乱
 成立业委会问题	组织、推选
投诉门口保安不让进入不合理问题	保安不当行为
咨询经济适用房和其他房屋的物业非是否是一样的	物业费
摄像头损坏的问题	日常服务不到位
物业私自占用公共道路	质量和水平
下水道返水无人管理的问题	入户维修态度及质量差
协调和平里街道办事处综合治理部门不给安装摄像头	监控实施损坏
小区物业服务态度恶劣	入户维修态度及质量差
私自涨物业费不合理问题	物业费
永定镇云翔嘉苑小区将人车混行通道设置成人车分行通道	安全秩序没保障
希望把广告撤掉	日常服务不到位
不给更换地砖	入户维修态度及质量差
小区摄像头维修问题	监控实施损坏
投诉保安不让租户的车入内“12315热线来电”	保安不当行为
物业使用公共基金维修电梯不合理	申请与使用
停车秩序混乱	秩序混乱
停车公司以地库装修为由拒绝业主车辆进入，导致小区居民无处停车	秩序混乱
监控探头无法使用	监控实施损坏
物业不退装修押金	物业费
北京乐生活物业公司违法在小区内进行商业销售活动#市政府门户网站互动交流平台#	日常服务不到位
物业管理混乱	保安不当行为
由居民推选新的业委会	组织、推选
监控故障一直无人修缮的问题	监控实施损坏
收费与服务不符	物业费
希望指导小区成立业委会	组织、推选
保安清晨聊天不合理	保安不当行为
市民反映要求物业把小区电梯换一个质量好一点的品牌	申请与使用
外来车辆随意进入小区停车，导致业主无处停车	秩序混乱
小区大部分监控无法使用	监控实施损坏
开发商收取安装新能源汽车充电桩费用，居民对此意见大	管理费
社区居委会上门找业主签字是否得到街道的许可	缴纳与监管
天通苑北一区物业乱收费	管理费
不交停车费不让出小区	管理费
单元门门禁损坏，影响居民出行，希望尽快维修	日常服务不到位
小区没有监控摄像，存在安全隐患，希望增设	监控实施损坏
西城区广外街道手帕口南街1号郎琴园小区物业不作为	日常服务不到位
车被划伤物业不给调取监控	态度与规范
咨询物业收取装修管理费是否有规定	管理费
楼道电灯电线暴露存在安全隐患问题	缴纳与监管
东沙各庄村收取物业费不合理问题#微博私信#	物业费
物业不退还垃圾清运费	垃圾清运费
小区没有业委会，希望成立	组织、推选
朱各庄小区业委会拖欠物业费不合理	权力运作及监督
咨询物业代环保局收费是否合理	物业费
希望协调解决长丰园三区成立业主委员会问题【北京市委书记蔡奇】#领导留言板#	组织、推选
小区路改变为市政道路不合理的问题	安全秩序没保障
小区内停车秩序差无人管理	秩序混乱
物业不作为/保密	入户维修态度及质量差
国务院信访办保安推人	保安不当行为
希望尽快成立业主委员会	组织、推选
居委会不了解居民情况	权力运作及监督
物业收取工本费又收取押金不合理	管理费
单元门锁坏的问题	安全秩序没保障
未经业主同意安装电梯问题	质量和水平
物业多收物业费的问题	物业费
西罗园二区宝汇苑8号楼楼门口停车秩序差#微博#	秩序混乱
垃圾清运费收两次是否合理	垃圾清运费
协助支付修车款项	安全没保障
反映单元门坏了一直无人维修问题	安全秩序没保障
建议粉刷楼道内墙壁	申请与使用
不按照政府计量标准收费	自供暖社区供暖费
来电咨询装修垃圾清运费的标准	管理费
厕所内公用下水管道漏水希望帮助协调维修	入户维修态度及质量差
物业不作为	管理简单粗暴
农光里144号楼一门一层住户私自开后门	安全秩序没保障
选举方式制度不全面	组织、推选
合众大厦物业不作为#市政府门户网站互动交流平台#	工作效率低
拆除丰台区东铁营街道刘家窑南里33号楼楼前停车桩	安全没保障
收费不合理	收费不合理
反映基础设施不完善，希望政府督促改进	监控实施损坏
物业把商户锁在瑞海大厦	管理简单粗暴
丰台和义西里三区停车秩序混乱【北京市委书记蔡奇】#人民网地方领导留言板#	秩序混乱
牛街东里一区私占车位问题#微博私信#	秩序混乱
物业管理差	质量和水平
停车秩序混乱	秩序混乱
小区物业不作为	入户维修态度及质量差
投诉物业收停车费不给发票。	管理费
小区停车秩序差	秩序混乱
物业掐电不合理	管理简单粗暴
核实一个物业两个小区价钱不一致的问题	物业费
 希望拆除门禁装置问题	安全秩序没保障
安排车位不合理问题	秩序混乱
房顶很多的树叉子无人清理问题	安全秩序没保障
丰台区科技园派出所不作为的问题	管理费
角门甲4号院5号楼6号楼物业不负责#市政府门户网站互动交流平台#	入户维修态度及质量差
反映希望取消隔离护栏	安全没保障
小区内停车秩序混乱	秩序混乱
供暖费收费问题	自供暖社区供暖费
更换热水表收费不合理	管理费
小区秩序混乱	安全秩序没保障
门禁损坏无人维修问题	日常服务不到位
小区停车位只卖不租，业主对此意见大	秩序混乱
反映自己的三辆车找不到的问题	安全没保障
小区收取装修押金是否合理	物业费
建议物业把小区间门禁卡改成一致门禁卡	态度与规范
物业乱作为	态度与规范
司机态度恶劣	态度与规范
物业费涨价不合理	物业费
更换筹备组组长尽快成立业委会	组织、推选
物业堵门不合理	管理简单粗暴
反映物业动用小区业主公共专项维修基金不合理的问题。	缴纳与监管
小区物业不作为	态度与规范
小区物业清理自己租户行为行为是否是村委会行为问题	管理简单粗暴
摄像头故障	监控实施损坏
物业乱收费，居民对此意见大	物业费
投诉物业不快速处理拉电线人员问题	安全秩序没保障
想知道具体什么时候搭建车棚	日常服务不到位
楼梯内扶手上有狗毛	日常服务不到位
未经住户允许安装门禁的问题#市政府门户网站互动交流平台#	日常服务不到位
物业安装监控不到位问题	监控实施损坏
希望安装摄像头问题	监控实施损坏
物业保安诬陷自己爱人偷狗	质量和水平
在门禁的位置贴告示提醒或者安装监控问题/保密	监控实施损坏
投诉物业服务质量	态度与规范
小区门损坏希望维修	安全秩序没保障
物业乱作为问题	管理简单粗暴
和平里街道办事处综合治理部门至今不给安装摄像头	安全没保障
乱停车	秩序混乱
小区车位被侵占，物业不处理	日常服务不到位
财富时代物业垄断小区宽带问题#微博#	管理简单粗暴
投诉儿童医院客服的问题	态度与规范
投诉物业公司不先申请维修水管公维基金不合理问题	管理简单粗暴
小区物业不作为	日常服务不到位
小区内未设置摄像头，希望增设	日常服务不到位
台阶年久失修不方便老年人出行	工作效率低
一栋洋房小区大修基金由个人管理不合理/保密	缴纳与监管
物业公司乱作为的问题	入户维修态度及质量差
开发商迟迟不移交物业管理权	安全没保障
打隔断群租，生活噪声扰民	管理简单粗暴
来电撤销	安全秩序没保障
小区物业雇佣不明身份人员当保安，希望查处	保安不当行为
小区没有物业导致环境脏乱，希望引进物业管理公司	组织、推选
投诉物业保安态度恶劣	保安不当行为
希望镇政府出面解决停车归属问题	秩序混乱
马桶不出水”96156热线来电“	态度与规范
希望安装摄像头问题	监控实施损坏
装修把烟道打了问题	管理简单粗暴
团结湖街道房管所服务态度不好	态度与规范
街道不对1、2号楼居民进行停车位登记	收费不合理
三义东里小区被非法安装电动车充电桩问题【北京市委书记蔡奇】#领导留言板#	态度与规范
物业不给补办电卡问题	质量和水平
物业不维修墙面	态度与规范
建议增设监控设施【北京市委书记蔡奇】#人民网地方领导留言板#  	监控实施损坏
物业不作为	质量和水平
物业服务不到位	质量和水平
物业未经业主同意强制建设停车位	管理简单粗暴
开发商不给新物业开办物业办公用房	申请与使用
富丰园小区无法建设停车场	质量和水平
佳世苑小区选取业主委员会违规操作	组织、推选
抽烟无人管理问题	保安不当行为
收取租户卫生费不合理	垃圾清运费
要求物业公示收费标准	垃圾清运费
居委会和物业拿走市民在楼道放的东西	管理简单粗暴
北京交警app无法办理进京证问题	申请与使用
建设立体停车场不合理	安全没保障
物业不给自己开同意安装证明	日常服务不到位
违章停车影响居民正常出行问题	秩序混乱
物业收取自来水及中水的费用贵/保密	管理费
小区物业乱收费	管理费
海淀区燕保温泉家园小区物业不作为问题	管理简单粗暴
小区物业入户维修态度及质量差	入户维修态度及质量差
锁车不合理	收费不合理
物业收取垃圾清运费和装修费过高问题	垃圾清运费
物业未经允许设立收费岗亭#市政府门户网站互动交流平台#	管理费
物业未经业主同意私自上涨物业费，业主对此意见大	威胁恐吓业主
协调相关部门尽快帮助处理和平里街道办事处综合治理部门至今不给安装摄像头	监控实施损坏
物业不作为	态度与规范
厨房烟道漏烟无人解决，影响居民正常生活	管理简单粗暴
小区出现大量跳蚤影响生活问题	安全秩序没保障
希望解决小区内卖臭肉影响正常生活问题	日常服务不到位
监控设施未启用系统不健全	监控实施损坏
物业私自断水电，业主对此意见大	管理简单粗暴
安全秩序没保障	安全秩序没保障
跟换物业后物业不走问题	日常服务不到位
业主私占公共车位，导致他任无处停车	场地紧张
小区业主没有地方停车希望加强管理	秩序混乱
希望安装充电桩	质量和水平
黑物业	管理简单粗暴
收取停车费高不合理	收费不合理
停放共享单车影响出行	秩序混乱
因物业拖欠垃圾清运费，导致小区内垃圾迟迟未清理，影响居民生活环境	垃圾清运费
物业断水断电	管理简单粗暴
协调更换物业管理	缴纳与监管
上调停车位价格不合理	管理费
移除鸟窝	安全没保障
物业出租地下室问题	日常服务不到位
莱圳家园小区业主管理的公共收益资金一直被物业非法侵占#APP#	组织、推选
业主提前排队导致进出不便的问题	秩序混乱
5号楼和6号楼电梯报警都是坏的	监控实施损坏
供暖公司收费不合理	自供暖社区供暖费
投诉职能部门不作为/保密	威胁恐吓业主
物业公司工作人员态度恶劣	威胁恐吓业主
楼道灯不亮	质量和水平
映溪城家园东区12号楼703室尸臭影响其他业主正常生活	入户维修态度及质量差
希望职能部门核实此集资是否违法	权力运作及监督
小区内停车秩序差	秩序混乱
希望核实事故和责任方	安全秩序没保障
小区收取供暖费	自供暖社区供暖费
小区物业高价售电及夏天频繁停电【北京市委书记蔡奇】#人民网地方领导留言板#	态度与规范
投诉物业对小区管理差问题	管理简单粗暴
房东不帮助调看监控	质量和水平
物业不给交电费	管理简单粗暴
莱圳家园占用消防通道停车问题#APP#	秩序混乱
水箱常年无人清理	申请与使用
无自行车停车位	安全秩序没保障
安装监控	监控实施损坏
中铁奥林匹克花园二区成立居委会	组织、推选
补充三位住户信息的问题	组织、推选
投诉水表维修客服推诿	入户维修态度及质量差
强烈要求督促政府部门解决物业与居民矛盾	管理简单粗暴
热力公司出租给文化创意园不合理的问题	日常服务不到位
核实小区停车场是否进行了备案	安全没保障
小区飘线充电动汽车问题	安全秩序没保障
小区防盗门故障	申请与使用
建议在小区停车场安装监控器	安全秩序没保障
金兴路1号院1号楼6单元602室内将单元门禁破坏	安全秩序没保障
居民固定停车位申报不了	申请与使用
小区内停车收费是否有资质	收费不合理
投诉物业	态度与规范
业委会要轰走小区小装修公司不合理的问题。	权力运作及监督
物业不作为	入户维修态度及质量差
小区内停车管理秩序差，希望物业加强管理	日常服务不到位
小区临时物业管理混乱，希望聘请正式物业入驻小区	权力运作及监督
保安上班期间聊天声音扰民	保安不当行为
希望协调处理城北街道联系自己进行协调处理停车位问题	秩序混乱
小区监控无人管理问题	监控实施损坏
协调小区物业尽快退回多收物业费	物业费
小区西墙倾斜存在安全隐患	安全秩序没保障
希望有关部门协调规划停车位方便业主停车	秩序混乱
小区物业费收费不合理问题	物业费
市民反映小区收费不合理的问题	管理费
成立业委会受阻	组织、推选
物业不管理小区	管理简单粗暴
纱窗坏了无人维修问题	质量和水平
物业违规收取装修保证金，居民意见大	管理费
中弘北京像素小区卫生间出租未公示	管理费
物业管理简单粗暴	管理简单粗暴
居委会保安不让自己参加会议	管理简单粗暴
小区内商用情况泛滥问题【北京市委书记蔡奇】#人民网地方领导留言板#  	日常服务不到位
物业规定不合理	管理简单粗暴
了解公共维修基金问题	缴纳与监管
小区新旧物业有纠纷不合理	管理简单粗暴
停车秩序混乱	秩序混乱
投诉物业不作为	管理简单粗暴
小区内停车秩序差，希望加强管理	安全没保障
反映小区地下车库停车杆常年不放管理差问题	安全没保障
小区不让业主成立业委会不合理问题	组织、推选
物业不给自己充电字	态度与规范
小区治安监控损坏	监控实施损坏
物业服务质量差问题	质量和水平
收取网络资源占用费是否合理“12315热线来电”	管理费
希望小区安装门禁设施问题	日常服务不到位
物业是否可以收物业费	物业费
加强安保力度问题	保安不当行为
金惠园三里无大门#市政府门户网站互动交流平台#	安全秩序没保障
楼内护栏损坏，希望物业尽快维修	申请与使用
还有大部分人居住的待拆迁地区没有监控不合理	监控实施损坏
社区保安把自己煤气罐拉走	保安不当行为
 天岳恒房屋管理有限公司供暖费收费不合理	自供暖社区供暖费
怡馨家园小区北部和东部收取停车费不合理	收费不合理
水郡长安小区推选业委会是违规操作要求从新选举	权力运作及监督
老旧小区停车及收费问题	收费不合理
保安不让进入问题	保安不当行为
物业长期占用小区活动用房和设备间，用于居住和堆放杂物	管理简单粗暴
希望物业公司入驻小区	组织、推选
物业雇佣年长保安不合理	保安不当行为
物业服务态度差	态度与规范
小区保安态度不好要开除问题	保安不当行为
小区内存在安全隐患问题	安全秩序没保障
物业不开发票	自供暖社区供暖费
公开业委会和物业账目	缴纳与监管
物业乱收费问题“12358热线来电”	管理费
未经业主同意，物业私自动用公共维修基金，业主对此意见大	申请与使用
物业擅自动用公共维修基金，自称用于维修消防系统，业主此意见大	申请与使用
门禁卡费用收取不合理	态度与规范
市民富人民院物业侵占公共区域	工作效率低
保安不让进	保安不当行为
物业动用维修基金未公示业主	申请与使用
住房公共维修基金提取及物业乱收费问题	缴纳与监管
停车占用公共绿地存在安全隐患	安全秩序没保障
同馨家园物业威胁恐吓业主	威胁恐吓业主
保安不让停车	保安不当行为
天岳恒物业乱收管理费	管理费
出入小区查身份证不合理	态度与规范
停车优惠证办不下来	安全没保障
没有业主委员会出现乱收停车费人员问题	组织、推选
物业态度恶劣	管理简单粗暴
不让安装防盗门不合理	管理简单粗暴
修管道挖坑未恢复原状问题	日常服务不到位
建设墓地不合理	管理简单粗暴
投诉鸿翔联物业有限公司物业保安存不合格	保安不当行为
立体车库建设不合理的问题	秩序混乱
物业不作为	入户维修态度及质量差
物业签署20年的使用权合同不合理问题	收费不合理
监控器坏了无人修理	监控实施损坏
业委会批示什么时候给发	组织、推选
希望相关部门帮助协调浇竹子保证正常生长	日常服务不到位
德佳物业私自拉业主电闸	质量和水平
业委会选举不公问题	组织、推选
核实如何向政府申请物业公司收费的依据和数额标准的问题	管理费
小区收取停车费不合理	管理费
保安做法不合理	保安不当行为
希望路劲世界城小区的两限房和商品房合并在一起	安全秩序没保障
投诉物业不作为	管理简单粗暴
建筑垃圾无人清理	垃圾清运费
小区给三个门禁不合理的问题	物业费
金域缇香家园没有社区管理#市政府门户网站互动交流平台#	组织、推选
门禁卡收费不合理问题	管理费
小区地下车库被出租，影响居民停车	安全没保障
小区安保不严问题	安全秩序没保障
不允许市民租户进屋	受破坏及法律权益保障
小区物业与前业主委员会私自挪用公维金的问题	入户维修态度及质量差
物业未经业主同意，违规动用公共维修基金维修消防通道，居民对此意见大	申请与使用
卡布小区物业擅自动用公共维修基金及收入公开#市政府门户网站互动交流平台#	申请与使用
投诉保安骂人	保安不当行为
龙跃苑二区小区居委会的党支部的不公平现象	权力运作及监督
楼道无人清理	垃圾清运费
核实监控的监管单位	监控实施损坏
小区内化粪池无人清理导致满溢，希望物业尽快处理	管理简单粗暴
希望小区物业加强管理小区配套设施	日常服务不到位
成立业委会问题	组织、推选
物业在小区道路上放墩子不合理	日常服务不到位
物业不作为	秩序混乱
没有发卫生管理费的问题	管理费
希望尽快维修窗户	入户维修态度及质量差
收费停车场安全没保障	安全没保障
成立两个业主委员会不合理	组织、推选
汽车无法进入地下车库	安全没保障
关闭小区内摄像头不合理	监控实施损坏
小区内送报箱破损，希望及时维修	申请与使用
百万庄小区长时间未使用摄像系统12315热线来电	监控实施损坏
投诉北京华泰龙安物业管理有限公司	质量和水平
希望归还装修押金	管理费
多收300元垃圾清理费不合理	垃圾清运费
小区物业私自拉走自家摩托车问题	管理简单粗暴
小区居民高空抛物，影响行人出行安全	日常服务不到位
小区安全秩序没保障	安全秩序没保障
业主私占停车位无人管理问题	秩序混乱
物业车辆管理员服务质量差	秩序混乱
蒲安里小区停车秩序混乱	秩序混乱
占用小区内面积建设居委会办公室不合理问题	受破坏及法律权益保障
希望恢复监控设备	监控实施损坏
小区管理混乱的问题	安全秩序没保障
更换新物业和成立业委会	管理简单粗暴
希望尽快发放房本费和房本税费	管理费
监控无法调取回放	监控实施损坏
北京京奥港置业有限公司挪用契税及公共维修基金#市政府门户网站互动交流平台#	申请与使用
物业违法消纳建筑垃圾	垃圾清运费
因拖欠房租被关门导致学员经济受损引发问题#微博#	态度与规范
通州区怡乐中街靓景明居小区私有车位收取管理费不合理问题【北京市市长陈吉宁】#人民网地方领导留言板#	管理费
地下室住人的问题	质量和水平
希望延期缴纳供暖费也可以用电	自供暖社区供暖费
希望恢复物业管理。	质量和水平
小区垃圾无人清理问题	日常服务不到位
绿地集团北京京坤置业有限公司迟迟不给面积差的问题	物业费
物业不处理下水管道返水导致自家被泡的问题	态度与规范
电梯频繁故障，影响居民出行	安全秩序没保障
物业不作为乱收费的问题	自供暖社区供暖费
停车管理员对于停错位置是否应该告知“12315热线来电”	安全没保障
停车秩序差	秩序混乱
业主不同意拆除小区花园问题	质量和水平
门禁不给市民授权问题	保安不当行为
小区内推选、成立业委会问题	组织、推选
物业没收自己东西不合理	日常服务不到位
小区物业不让停车不合理问题	日常服务不到位
核实绿城百合小区物业是否有收取停车费的资质	收费不合理
小区内无监控设施，居民担心有隐患，希望安装	监控实施损坏
业委会选举人员违规	组织、推选
物业工程部的工作人员工作不认真	入户维修态度及质量差
物业动用公共维修基金拆除房屋房檐不合理的问题	申请与使用
未经业主同意物业私自挪用公共维修基金	申请与使用
物业乱收停车费，居民对此意见大	管理费
物业不作为	态度与规范
物业违规收取灯电费、卫生费、装修管理费不合理#今日头条私信#	管理费
德佳物业与东城区房管局未经业主允许挪用公共维修基金	申请与使用
希望安装摄像头	监控实施损坏
监控故障问题	监控实施损坏
希望协调安装监控	监控实施损坏
国通家园小区停车管理混乱	秩序混乱
楼顶外护栏松动无人处理	质量和水平
业主不交物业费就不让买中水不合理	管理简单粗暴
收取供暖费不合理	自供暖社区供暖费
不让进小区	安全没保障
市民反映业委会人员不作为问题	受破坏及法律权益保障
小区无人管理	日常服务不到位
物业收取装修管理费不合理	物业费
撤销反映小区物业收取管理费不合理的问题/保密	管理费
电梯内电子广告占用面积过大，影响居住环境/保密	权力运作及监督
石榴物业违规建停车位“12319热线来电”	管理简单粗暴
楼下监控损坏	监控实施损坏
房山区良乡玉竹园小区物业经理不作为	态度与规范
物业私自更换小区门禁系统并收取管理费，居民意见大	管理费
监控故障无人维修	监控实施损坏
整治村里乱停车问题	秩序混乱
物业让交不合理的供暖费	自供暖社区供暖费
物业强制扣留水、电卡断水断电问题	管理简单粗暴
地铁站A口自行车棚停车收费不合理	收费不合理
小区居民楼前化粪池排污管设置不合理	态度与规范
物业不收取自己停车位费	态度与规范
朝阳区南十里居东风家园18号楼物业不作为的问题	质量和水平
未经业主同意，物业私涨停车费，业主对此意见大	收费不合理
物业未经业主同意上涨停车费，居民对此意见大	管理费
物业不让车进小区问题	态度与规范
物业收取施工保护费不合理的问题	管理费
大兴区西红门镇黄亦路金星庄北门门口保安不让进入小区	保安不当行为
希望实处理彻底取缔或清退落选业委会的问题/保密	权力运作及监督
私占停车位	秩序混乱
小区内可以继续使用充电桩	质量和水平
建议在路段设立公共区域摄像头	监控实施损坏
大量充电动车有安全隐患问题	安全秩序没保障
西冉德顺园物业不给开发票的问题#市政府门户网站互动交流平台#	物业费
小区摄像头对准市民卧室	监控实施损坏
物业保安不作为	保安不当行为
小区物业将车位提供给非业主使用	秩序混乱
香悦四季业委会成员滥用职权问题	权力运作及监督
投诉保安不让进北部文化中心	保安不当行为
西直门北大街43号院不给安窗户问题#微博#	入户维修态度及质量差
物业乱作为	安全没保障
协调在小区内成立业委会	组织、推选
市民反映小区保安推走自己电动车问题	保安不当行为
迟迟不安装门禁	安全秩序没保障
希望及时清理报废面包车问题	秩序混乱
物业出租自行车棚	安全没保障
乱收费用	管理费
楼上住户向下扔垃圾	管理简单粗暴
希望小区增设监控设施并维护地面监控	监控实施损坏
要求物业给自己赔偿	态度与规范
刘二村保安不让开车进村影响正常生活	保安不当行为
物业收费问题	物业费
收取水费和卫生费和车辆费用不合理	管理费
小区内监控摄像头无法正常使用	监控实施损坏
业委会冒用居民姓名领取公维基金	权力运作及监督
物业不让安装充电桩问题	管理简单粗暴
希望修门禁卡	质量和水平
四季青镇常青园三区业委会主任发布虚假通知	权力运作及监督
尽快修复楼门禁	安全秩序没保障
小区单元楼内没有灯看不见路物业不管	工作效率低
物业不作为	质量和水平
市民反映车库违法改装成房屋出租问题	安全没保障
杨庄小区存在私占停车位问题#微博#	秩序混乱
小区车库升降设备故障，影响居民停车	秩序混乱
物业管理员工不当	日常服务不到位
统一组织进行户内及公共区域消杀蟑螂 #市政府门户网站互动交流平台#	组织、推选
监控不能正常使用	监控实施损坏
希望协调物业给楼体安装吊篮	质量和水平
协调安装充电桩	秩序混乱
协调恢复之前的车位费	收费不合理
收费不合理	收费不合理
物业收取垃圾清运费不合理	垃圾清运费
帮助了解物业不处理水管爆裂的后续工作	态度与规范
保安经理态度恶劣	保安不当行为
物业管理服务态度差问题	态度与规范
新能源汽车拉线充电有安全隐患问题	监控实施损坏
办事处阻止办业委会问题	组织、推选
物业迟迟不给处理占用车位问题	秩序混乱
物业保洁人员工作不负责任	日常服务不到位
要求退还2017年-2019年的照明管理费	管理费
开发商给市民答复并且尽快把燃气管道挪回地下	管理简单粗暴
物业换的管道与实际型号不符	入户维修态度及质量差
物业不作为	日常服务不到位
消除供暖费未缴纳记录以免为自己未来带来不良影响	自供暖社区供暖费
希望协调清理旧家具问题	日常服务不到位
物业费收取不合理	物业费
无法出停车场	秩序混乱
物业收费不合理	管理费
望小区内业委会可以公开选举以小区业主来选举业委会成员	组织、推选
希望能够打开小区摄像头/保密	监控实施损坏
物业收取电梯费不合理	物业费
更换物业问题	日常服务不到位
停水停电的问题	威胁恐吓业主
建议小区成立居委会	权力运作及监督
物业查表工作不到位导致多收自己水费	管理费
物业不公布广告牌收入和维修基金账目	缴纳与监管
楼道卫生差	工作效率低
核实租金去向	管理费
物业涨停车管理费不合理	收费不合理
询问物业费是否有明文规定	物业费
物业收钱不合理	管理费
物业不退费问题（领导接听）	管理费
物业未经业主同意动用公维基金，居民对此意见大	申请与使用
希望尽快让自己的拉货车进入小区	管理简单粗暴
北京天和盛京物业管理有限公司乱作为问题	威胁恐吓业主
物业设置车辆通行杆，进入小区强行收费不合理	管理简单粗暴
北京太阳城小区被解聘的物业保殴打业主问题#微博#	保安不当行为
楼道内存放破旧自行车无人清理	质量和水平
不让安装充电桩	管理简单粗暴
物业不给自己开具装修证明的问题	垃圾清运费
小区门禁安装后未启用，小区安保差，希望启用门禁系统	安全秩序没保障
物业给予自己损失	日常服务不到位
投诉居委会和物业阻挠小区成立业主委员会	组织、推选
停车收费不合理“12358热线来电”	收费不合理
小区内保安服务态度差，希望加强管理	保安不当行为
商务性公寓都在退公共维修基金，富力未按照规定退还	缴纳与监管
核实是否有回迁房第一年不交物业费的规定	管理费
投诉物业只管收钱不管车辆出现问题	日常服务不到位
物业迟迟不走/保密	组织、推选
物业打开东门不合理	管理简单粗暴
 投诉物业绿化规划不合理	权力运作及监督
投诉北京国豪物业管理公司	管理简单粗暴
小区树木被拔	管理简单粗暴
业委会不作为	组织、推选
帮助使用北京业主APP	受破坏及法律权益保障
投诉街道社区办郭斌	态度与规范
小区内开设健身房，导致外来人员可随时进入，希望加强治安管理	安全秩序没保障
翠微南里14号楼门前没有停非机动车的地方	秩序混乱
小区外乱停车的问题	秩序混乱
恒安6号楼防水油毡脱落	安全秩序没保障
物业不作为	质量和水平
保安不履行职责的问题	安全秩序没保障
表扬居委会领导工作认真负责问题	权力运作及监督
希望帮助协调安装护栏	安全没保障
反映单元门门禁无法关闭	安全秩序没保障
物业不作为	质量和水平
小区门禁故障不维修存在安全隐患问题	安全秩序没保障
经济适用房不严实，经常发出异响	日常服务不到位
物业不作为	态度与规范
把地下车库改成收费停车场不合理	收费不合理
奥林park小区业委会迟迟未成立	组织、推选
施工导致出行不方便问题	垃圾清运费
小区物业不让使用停车位	秩序混乱
物业服务不好	态度与规范
供暖公司未按收取供暖费，业主对此意见大。	自供暖社区供暖费
业委会筹备组要求公布业主信息不合理问题	受破坏及法律权益保障
物业收取垃圾处理费是否合理	垃圾清运费
物业迟迟不给更换防盗门	入户维修态度及质量差
物业不作为	物业费
公共维修基金使用不合理	缴纳与监管
物业管理不善	安全秩序没保障
大队拖欠物业费	物业费
物业公司收取地下室储藏间面积费用不合理	申请与使用
小区安保力度不足，希望加强管理	保安不当行为
北京市供暖办监管不利问题	质量和水平
物业不给开证明无法安装充电桩	态度与规范
协调小区物业修车	质量和水平
反映咨询北京市停车收费标准@“12315热线来电”	收费不合理
希望去除木板上的钉子	质量和水平
反映怀柔区泉河街道泉河园2区换物业问题	权力运作及监督
小区物业收费过高不合理问题	物业费
自己小区还让敲门不合理	日常服务不到位
物业不作为	入户维修态度及质量差
康泽园小区十号楼前建立立体停车场不合理#微博私信#	安全没保障
小区内施工车辆与业主共同使用一个出入口不合理	秩序混乱
停车秩序混乱	秩序混乱
暖气不通热问题	自供暖社区供暖费
小区保安强制自己填写个人手机号不合理问题	保安不当行为
相关部门尽快帮助处理和平里街道办事处综合治理部门至今不给安装摄像头	监控实施损坏
单位不予缴纳维修基金的问题	申请与使用
物业不核查下水堵塞原因问题	态度与规范
小区物业不作为	权力运作及监督
小区内私自安装充电桩存在安全隐患的问题	日常服务不到位
天竺花园物业不给充水费不合理	物业费
盛德东兴家园南区10号楼物业不作为	管理简单粗暴
物业不卖水及房屋卫生间漏雨	管理简单粗暴
物业不合理建造停车场	安全没保障
物业不作为	入户维修态度及质量差
收费改造光纤、在承重墙上打洞的问题	入户维修态度及质量差
门禁损坏无人维修	缴纳与监管
小区物业不作为	安全秩序没保障
希望帮助了解甘东居委会能否有权开监护人证明	权力运作及监督
业委会重新选举，迟迟未公布竞选结果	组织、推选
小区坏境差	日常服务不到位
物业不给安装充电桩	申请与使用
了解致电原因	管理费
希望安装监控和维修监控	监控实施损坏
邢各庄村幼儿园门口监控不清楚#市政府门户网站互动交流平台#	监控实施损坏
投诉物业不作为问题	入户维修态度及质量差
没有物业为什么收取物业费	物业费
车辆乱占车位无人管理的问题	秩序混乱
小区物业恐吓威胁谩骂业主	威胁恐吓业主
物业收取装修押金和装修管理费不合理，而且物业私自断水电	管理费
物业出租民宅是否合法	态度与规范
首创悦都会小区地下停车库安全隐患问题“12350热线来电”	安全没保障
反映自己的车被堵住的问题。	保安不当行为
乱收停车费	管理费
物业乱收费	管理费
莱圳家园小区业主管理的公共收益资金一直被物业非法侵占#APP#	组织、推选
房子质量问题	质量和水平
物业费上涨不合理	质量和水平
反映小区物业行为问题	工作效率低
协调开发票	态度与规范
商务性公寓都在退公共维修基金，富力未按照规定退还	缴纳与监管
小区业委会迟迟无法改选	组织、推选
小区没有居委会	组织、推选
小区每栋楼防盗门密码都一样不安全问题	安全秩序没保障
东坝家园物业费收取太高	物业费
物业收自己1000元钱不合理	管理费
物业不给赔偿款	质量和水平
投诉物业收费不合理/保密	管理费
协调退租房费用	管理费
外来物业强行进住小区	威胁恐吓业主
小区内卫生清理不及时，影响居住环境	日常服务不到位
修理管道留下来的坑没有填平	管理简单粗暴
开发商强占自己房屋	管理简单粗暴
物业乱作为	管理简单粗暴
物业动用公共维修基金不合理问题	申请与使用
协调退回装修押金	缴纳与监管
保安未说任何原因不让市民开车进小区的问题	保安不当行为
房地产商捆绑销售   	受破坏及法律权益保障
村子里监控设施损坏无人修理问题	监控实施损坏
投诉物业保安宋雪峰态度差	态度与规范
居民擅自破坏小区墙面	安全秩序没保障
物业私自涨停车服务费用不合理	收费不合理
物业不让进行小区停车的问题	质量和水平
物业没有按照流程启动维修基金	申请与使用
物业不作为的问题	物业费
小区物业私自动用公共维修基金的问题	缴纳与监管
物业收费不开发票	管理费
私自锁车不合理的问题	申请与使用
物业非法断电的问题	管理简单粗暴
市民反映小区人脸识别系统不合理问题	缴纳与监管
物业不作为	物业费
物业迟迟不报销	安全没保障
上营北区业委会及居委会不作为	权力运作及监督
街道无故取消业主委员不合理	组织、推选
小区车位价格高	收费不合理
保安职责问题	保安不当行为
协调筹建小区业委会【北京市委书记蔡奇】#人民网地方领导留言板#	组织、推选
希望尽快启用小区单元门门禁	安全秩序没保障
禁止外来车辆到小区内停车问题	秩序混乱
物业掐断供暖的问题	威胁恐吓业主
核实了解东辛房街道是否有相关规定不在工作时间不允许使用公共充电桩充电	保安不当行为
居民委员会选举方式不合理	权力运作及监督
物业不作为	入户维修态度及质量差
物业私装基站	管理简单粗暴
小区内广告扰民	日常服务不到位
收取装修垃圾清运费不合理	垃圾清运费
村大队进行环境治理导致自家无法排放雨水	入户维修态度及质量差
小区大门长期开放不合理	日常服务不到位
小区租赁车位条件不合理	收费不合理
业委会不作为问题	权力运作及监督
协调尽快成立业委会问题	组织、推选
小区物业和保安对快递车进行收费才让进小区不合理	保安不当行为
桥修好了不通车	申请与使用
协调相关部门开通小区的监控	监控实施损坏
小区物业乱收费	缴纳与监管
反映北京晟邦物业管理有限公司乱收费	管理费
物业划停车位不合理	安全没保障
小区治安差，存在安全隐患	安全秩序没保障
站岗没有责任心	质量和水平
小区监控损坏，导致频繁丢失电动车无法调取监控，希望尽快维修	监控实施损坏
希望封存地库	安全没保障
门禁不锁导致其他人员可以随便进入问题	态度与规范
外来车辆进入小区无人处理	秩序混乱
无法成立业委会	组织、推选
主管道维修业主自己掏钱不合理	权力运作及监督
物业装修管理费不退和装修垃圾清运费只退一半不合理问题	管理费
保安拦截	保安不当行为
垃圾无人清理#微博私信#	日常服务不到位
物业需本人到场领取是否合理	日常服务不到位
反映单位不予缴纳维修基金	申请与使用
市民反映物业问题	物业费
物业强制断电不合理的问题	管理简单粗暴
小区楼道潮湿，出行有安全隐患	日常服务不到位
停热水不合理问题/保密	日常服务不到位
物业公司贴违停通知做法不合理，业主对此意见大	安全没保障
停车位坑洼，无人处理	安全没保障
保安私自拿东西	保安不当行为
物业公示门禁卡办理截止时间为4月30日，现在不让未办理门禁卡的业主进小区不合理	管理简单粗暴
小区门口监控室保安夜里睡觉问题	保安不当行为
物业不处理摄像头照墙的问题	安全秩序没保障
物业用非法手段逼迫业主交物业费	威胁恐吓业主
物业擅自动用公共维修基金，自称用于维修消防系统，业主此意见大	申请与使用
胜古中路1号院3号楼没有公共维修基金的问题	申请与使用
加装天然气报警阀收费不合理	管理费
保安不作为	保安不当行为
物业强制要求缴纳滞纳金不合理	物业费
物业不卖电	管理简单粗暴
物业不作为	入户维修态度及质量差
来电撤消诉求。	威胁恐吓业主
物业尽快维修维修自家门铃	入户维修态度及质量差
希望相关部门核实处理无处停车问题	场地紧张
小区成立业委会不合理	组织、推选
小区停车管理混乱	秩序混乱
监控损坏	监控实施损坏
物业收取水费不合理问题	物业费
物业不作为	质量和水平
小区内安全没有保障	监控实施损坏
物业收取垃圾清运费不合理	垃圾清运费
物业出租自行车棚	日常服务不到位
门禁损坏无人维修	日常服务不到位
物业不作为	入户维修态度及质量差
小区地下车库迟迟不开放，导致居民无处停车，希望地下车库尽快投入使用	态度与规范
物业收取生活垃圾清运费不合理	物业费
小区成立业委会需要由那个部门给盖章处理	保安不当行为
监控线冒火花问题	安全秩序没保障
镇政府拒绝成立业委会不合理的问题	组织、推选
协调物业使用公共维修基金维修飘窗	申请与使用
无法申请大修基金	申请与使用
 对着自己家安装摄像头不合理	监控实施损坏
小区业委会内部混乱问题	组织、推选
小区未按照市政标准收取水费，居民对此意见大	管理费
街道不给业委会备案	权力运作及监督
物业更换室外水表收费不合理问题	管理费
希望相关部门帮助顶秀金颐小区协调成立业委会【北京市市长陈吉宁】#领导留言板#	组织、推选
 电动车飞线充电	态度与规范
昌平区马池口镇玉龙家园小区物业收取电费高	管理费
拆除所有地锁后会导致小区停车秩序混乱	秩序混乱
小区内乱停车	秩序混乱
举报星光公寓小区业委会主任#微博#	权力运作及监督
协调成立业委会	组织、推选
希望帮助清理汽车上的水泥	安全没保障
希望住建委督促物业尽快提交材料问题	组织、推选
小区保安因为自己骑电动车不让自己进小区	保安不当行为
物业乱收费	管理费
希望核实小区内如何停车	秩序混乱
小区乱作为问题	管理简单粗暴
物业不作为	质量和水平
物业维修人员态度恶劣问题	态度与规范
开发商给业委会办公室贴封条不合理	受破坏及法律权益保障
小区内停车场出口未开放，影响居民出行	安全没保障
家委会服务态度差	态度与规范
小区内存在安全隐患的问题	态度与规范
财务账目没有公开	申请与使用
空调被停	日常服务不到位
公共停车区域不准停	保安不当行为
投诉物业不处理业主车辆被砸不合理	日常服务不到位
物业收取供暖费高，业主对此意见大/保密	缴纳与监管
安排正规物业对小区进行管理	权力运作及监督
小区监控显示器故障无人维修问题	监控实施损坏
物业迟迟不给退装修押金	管理费
充电桩安装不合理的问题	日常服务不到位
 保安不让业主车辆进入小区的问题	态度与规范
投诉物业绿化规划不合理	权力运作及监督
防盗门损坏无人处理问题	安全秩序没保障
物业不作为	质量和水平
物业乱收费的问题“12315热线来电”	管理费
希望修好门禁	安全秩序没保障
物业公司乱收费	收费不合理
投诉小区物业不作为	管理简单粗暴
物业保安不让业主进入小区	保安不当行为
希望增设一个社区医院	申请与使用
希望提高临时停车收费标准的问题	收费不合理
物业为经业主同意私自上涨物业费，业主对此意见大	物业费
物业擅自动用维修基金不合理问题	申请与使用
小区监控不完善	监控实施损坏
安德里北街属于哪个街道官	管理费
小区改造不合格	质量和水平
思源胡同老旧小区私占停车位【北京市委书记蔡奇】#人民网地方领导留言板#	秩序混乱
小区收取停车费不合理问题	收费不合理
询问物业收费标准#微博私信#	物业费
老业委会不把工作交接给新业委会导致无法正常工作的问题	受破坏及法律权益保障
小区没有居委会，居民办事不便，希望设立	组织、推选
核实处理小区内上述问题	安全没保障
安装监控	监控实施损坏
保安态度不好	保安不当行为
3号楼内1层监控故障	监控实施损坏
地下车库出口被封堵不合理的问题	安全没保障
物业乱收费	管理费
物业未经业主同意，私自上调停车费，业主对此意见大	管理费
物业乱扣费的问题	物业费
 私占停车位	秩序混乱
自家小区下水主管道堵塞	安全秩序没保障
电动车不让进入小区	保安不当行为
供暖滞纳金交付不合理问题	自供暖社区供暖费
物业收取维修费不合理	缴纳与监管
业主委员会投票不符合规定	权力运作及监督
物业调整停车费不合理的问题	管理费
未办理停车位产权登记开发商聘用物业未经业主同意收费	管理费
希望在小区电梯安装隔音层	质量和水平
投诉物业不作为	入户维修态度及质量差
垃圾异味和噪音扰民	质量和水平
希望相关部门协调降低停车费并分配给小区业主车位	收费不合理
小区居民没有居委会管理	组织、推选
希望物业尽快维修紧急呼叫系统	监控实施损坏
西山枫林四区6号楼1单元的单元门禁损坏，希望尽快维修	安全秩序没保障
物业未经业主同意张贴收取消防系统维护的资金	物业费
希望增设摄像头	监控实施损坏
建议增加摄像头	监控实施损坏
投诉管庄乡政府不履行职责	组织、推选
 学校门口乱停车有安全隐患	安全没保障
成立业委会流程不合理	组织、推选
物业工作方法不合理	管理简单粗暴
核实小区的住房维修基金去向	缴纳与监管
高空抛物	安全秩序没保障
开发商私自涨钱不合理	缴纳与监管
房屋质量及物业管理差问题	入户维修态度及质量差
世华泊郡电不能用	入户维修态度及质量差
物业不让车辆进小区	质量和水平
市民反映护国寺大街72号院疏解缓慢的问题	态度与规范
小区监控设备损坏，希望及时维修	监控实施损坏
楼道玻璃碎裂迟迟无人更换	安全秩序没保障
希望小区门口从新设立路墩问题	质量和水平
物业的装修垃圾清运费太高	垃圾清运费
小区停车秩序混乱，希望加强管理	秩序混乱
小区没有保安巡逻	安全秩序没保障
协商开放小区地下停车库	场地紧张
市民反映协调处理取暖费问题	自供暖社区供暖费
小区业委会破坏拆除鱼池	权力运作及监督
莱圳家园二期三期地下车库长期不维护管理问题#APP#	组织、推选
小区保安服务态度恶劣	保安不当行为
物业不退装修押金问题	管理费
小区物业服务态度不好问题	保安不当行为
保安室被私人占用，希望物业尽快处理	日常服务不到位
超市开业门口停车占用自行车道	秩序混乱
物业工作人员辱骂自己	态度与规范
物业不安装摄像头存在安全隐患的问题	申请与使用
物业收取门禁卡办理费规定不合理问题	管理费
小区业委会迟迟不能成立	组织、推选
收费不合理问题	管理费
北京徳利中天物业服务股份有限公司不退装修押金问题#微博私信#	管理费
小区停车混乱	秩序混乱
小区车位太窄	质量和水平
物业不作为	日常服务不到位
阜成门外大街13号楼环境卫生秩序差的问题#微博私信#	态度与规范
开发商迟迟未将公共维修基金上交职能部门	缴纳与监管
物业工作人员辱骂业主	威胁恐吓业主
楼道停放电动车无人管理，影响居民出行	秩序混乱
单元门安装人脸识别系统后迟迟未启用，希望尽快投入使用	质量和水平
协调加强角门东里小区的治安管理	安全秩序没保障
枣营北里6号楼伯宁花园院内绿地上私家车占用公共绿地	秩序混乱
不明诉求	安全没保障
希望完善小区监控问题	监控实施损坏
投票票数不合规	物业费
保安不让进入国际展览中心参展问题	保安不当行为
小区保洁员不全员上班“12320热线来电”	日常服务不到位
小区起名不合理	申请与使用
物业收费不合理	物业费
开发商没有缴纳两限房第一年物业费用的问题	物业费
希望物业取消改造的	安全没保障
物业不作为	工作效率低
投诉物业管理不当	日常服务不到位
小区内电动车摩托车停放楼道内很危险	质量和水平
来电希望增设超市	申请与使用
小区路灯坏了无人修理	安全秩序没保障
投诉物业和保安的服务态度差问题	日常服务不到位
物业提高物业费不合理	物业费
物业私自设置房屋租赁广告牌	态度与规范
小区内楼与楼之间违规停车问题	安全没保障
小区物业收取停车费管理混乱的问题	秩序混乱
咨询是否合理	垃圾清运费
物业公司工作人员态度恶劣	威胁恐吓业主
大兴区榆垡镇新机场工地指挥部私自售卖通行证不合理的问题	管理费
小区停车混乱希望物业加强管理	秩序混乱
枫泉花园小区没有居委会#市政府门户网站互动交流平台#	组织、推选
烟道被堵导致无法装修的问题	权力运作及监督
治理小区内自行车乱停	秩序混乱
物业收取垃圾清运费不合理	垃圾清运费
汇都家园小区车辆门禁无法登记	管理简单粗暴
底商装修物业收取押金一年后才能退还，底商对此意见大	缴纳与监管
金隅旺和园物业让自己补交供暖费不合理	自供暖社区供暖费
黑政府、黑保安、黑物业	质量和水平
居委会不给办理手续不合理问题	组织、推选
美丽经典小区车位上有树上鸟拉屎的问题	安全没保障
希望尽快维修好鸿博家园一期A区1号楼正对面的摄像头	监控实施损坏
酒店收费不合理的问题“12315热线来电”	收费不合理
开发商不给商铺供水电	管理费
自行车棚停车秩序差，希望加强管理	安全没保障
物业占用业主公摊面积建房对外出租的问题	入户维修态度及质量差
被小区内的设施绊倒希望有关部门帮忙协调赔偿问题	态度与规范
物业收取中水费不合理问题	态度与规范
物业管理	管理简单粗暴
希望东兴一区门口停车抬杆尽快能够使用/保密	安全没保障
物业不作为	质量和水平
顺义区治安较差的问题	安全秩序没保障
协调小区周边增设围栏	安全秩序没保障
通州区中仓街道因外墙保温工程导致摄像头无法正常使用	监控实施损坏
消防通道被堵	安全秩序没保障
物业让清理地下室不合理	管理简单粗暴
取消电梯内的电子广告的声音	管理简单粗暴
希望望京明苑尽快成立业委会	权力运作及监督
核实区供电何时未小区电梯安装做增容	申请与使用
物业不作为的问题	质量和水平
拿走电瓶不合理	安全秩序没保障
群租房	安全秩序没保障
对外租赁车位不合理	安全秩序没保障
小区停车物业让交罚款不合理问题	管理费
赔偿不合理问题	态度与规范
德佳物业迟迟不撤出小区	质量和水平
垃圾分类的钱没有给	垃圾清运费
街道办为何拒绝业主大会延期申请的问题	权力运作及监督
小区物业服务态度差	态度与规范
楼道垃圾无人清理问题	日常服务不到位
协调城华物业管理有限公司退押金	管理费
安全隐患问题	安全秩序没保障
当地物业违建房屋	态度与规范
物业私自断电	管理简单粗暴
投诉溪翁庄镇民政门口保安	保安不当行为
开发商交房不合格导致无法居住问题	权力运作及监督
小区垄断宽带运营商不合理	权力运作及监督
小区没有摄像头不合理	监控实施损坏
收费不合理	收费不合理
没有居委会导致自己小区无法成立业委会	组织、推选
业委会强行要求物业撤出不合理问题	权力运作及监督
核实相关政府部门是否可以监管物业提取维修基金并进行维修房屋的过程	申请与使用
小区内私装地锁现象普遍，希望统一拆除	物业费
物业未按合同规定收取停车费，违规调涨停车费，居民对此意见大	管理费
小区监控设施损坏	监控实施损坏
帮助打开室外空调压缩机飘窗问题	质量和水平
映收取装修管理费不合理	管理费
小区立体车库故障，导致业主无法停车，希望尽快维修	安全没保障
小区内停车秩序差的问题“向前一步”	秩序混乱
电卡清零才能购电不合理	质量和水平
物业在小区内部道路安装护栏影响出行	安全秩序没保障
 社保所工作人员招聘的社区保安不符合条件	保安不当行为
小区没有公共充电桩，导致新能源车无法充电，希望增设	入户维修态度及质量差
希望增设监控设施	监控实施损坏
希望物业协调安装坐便	态度与规范
物业不让快递员进小区不合理	日常服务不到位
私占车棚的问题	申请与使用
保安骂人	态度与规范
京师园小区业委会不让居民参加选举	组织、推选
小区停车位积雪无人清理	工作效率低
小区私自收停车费不合理	态度与规范
协调核实使用住房维修基金是哪批准的	申请与使用
协调物业让保安履行相应职责	日常服务不到位
小区不让业主的车辆和装修车辆进入小区问题	保安不当行为
燕海物业不合理收取停车费	收费不合理
小区物业收取物业费过高	物业费
卢西嘉园小区无法成立业主委员会	组织、推选
废品无人清理	垃圾清运费
核实尽快修复防盗门问题	安全没保障
物业不退宽带押金	管理费
咨询收取电梯运费是否合理	管理费
安装新能源充电桩收取1000元不合理	管理费
小区停车秩序混乱无人管理	日常服务不到位
协调物业将道路圆瓷砖换成防滑的瓷砖	安全秩序没保障
希望小区增加保温层、楼体扶手、升降杆	申请与使用
增设停车桩不合理问题	秩序混乱
物业乱收物业费	质量和水平
酒店不作为	态度与规范
物业不解决保安违规收费的问题	保安不当行为
物业不换水表问题	管理简单粗暴
车辆乱停乱放的问题	秩序混乱
解决未来家园车库未竣工问题	日常服务不到位
电动车充电问题	安全秩序没保障
西城区椿树街道椿树园小区鲁能物业制定不合理停车租赁合同不合理	威胁恐吓业主
小区物业乱收停车费	管理费
新老物业无法进行交接导致小区生活质量严重下降	组织、推选
了解到哪申请成立业委会	组织、推选
物业不作为垃圾无人清理的问题	质量和水平
 商户在小区建设消防通道不合理”12319热线来电“	受破坏及法律权益保障
上下水管道改造	缴纳与监管
希望物业清理楼道卫生和启用门禁	管理简单粗暴
物业私自断网	态度与规范
无法进入购买房子问题	质量和水平
小区没有居委会无法办理入学手续	组织、推选
停止成立业委会问题	组织、推选
泰禾拾景园居委会批申不过的原因	组织、推选
自己的车辆安全没保证问题	安全没保障
希望出示腾退证明	日常服务不到位
小区内落叶堆积无人清理，影响居住环境	日常服务不到位
咨询小区内有300多户能否成立业委会	组织、推选
物业不让装修商铺	管理简单粗暴
小区供暖公司一直未完成备案，居民担心无法按时供暖，希望协调解决	权力运作及监督
小黄车乱堆乱放进行清理	秩序混乱
监控安装位置不合理	监控实施损坏
物业不给处理保安不让自己出去的问题	保安不当行为
物业收取垃圾费规定不合理的问题	垃圾清运费
首创置业股份有限公司不履行购房减免一年物业费的承诺#APP#	物业费
小区物业管理不当	管理简单粗暴
物业不作为	缴纳与监管
希望取消一边绿化方便错车	场地紧张
北街家园一区物业私自使用公维基金招标安装监控的问题#评论#	申请与使用
恐吓业主	威胁恐吓业主
北京市园林学校的保安态度恶劣	保安不当行为
希望协调清理垃圾并树立禁止扔垃圾的标示问题	日常服务不到位
反映小区物业居委会不作为	质量和水平
厨房的油烟机接不上头	入户维修态度及质量差
物业未经业主同意，更换人脸识别门禁系统，且进行收费和身份认证，居民对此意见大	物业费
物业不作为	入户维修态度及质量差
自己应该向何部门要树砸了树的赔偿	申请与使用
协调希望可以公开招标新的物业公司进入小区进行管理	权力运作及监督
物业私自清理绿地铺成地砖的问题	管理简单粗暴
申请使用专项维修资金维护顶层滴漏	申请与使用
停车场按年收费不合理	管理费
核实小区业主是否按照每月150元缴纳停车费	安全没保障
物业乱收费	管理费
物业收费不合理	物业费
朝阳区潘家园街道豪景阁潘家园九号院希望协调安装充电桩问题	质量和水平
私自成立自管会跟私自收取停车费不合理	组织、推选
 物业不让装修商铺	日常服务不到位
物业私自涨停车收费不合理	管理费
物业给停电不合理	管理简单粗暴
房屋漏雨，希望帮助维修	日常服务不到位
协调搭车棚	安全没保障
物业不让安装护栏	管理简单粗暴
物业管理费过高	管理费
成立业委会受阻不合理	组织、推选
水郡长安小区选举业委会成员不合格	组织、推选
堵住消防通道	安全秩序没保障
物业带人殴打业主	威胁恐吓业主
香海园小区物业不作为	入户维修态度及质量差
长城物业不作为的问题	质量和水平
物业收取停热水钱不合理问题	管理费
希望相关部门核实是否是正规保安	保安不当行为
不同意盖房子导致没有公共场所影响小区房价	日常服务不到位
停车收费不合理	收费不合理
物业在京旺家园4区4号楼1门私自安装门禁导致居民无法出行	日常服务不到位
物业把车棚租给了建材	管理简单粗暴
小区乱收费	垃圾清运费
新村街道办事处未经业主同意让居委会进驻小区办公不合理问题	权力运作及监督
物业管理差	工作效率低
希望整改金地格林格林小区立体车库#微博#	安全没保障
小区物业不作为	申请与使用
物业不让电信宽带入住小区问题	管理简单粗暴
地下室住人	安全没保障
保安公司合同到期却不离职	保安不当行为
希望协调退回停车费	申请与使用
物业不作为	质量和水平
赛文斯塔物业管理有限公司异地办公及物业不作为#市政府门户网站互动交流平台#	权力运作及监督
国豪物业周日不给开空调不合理	态度与规范
小区地下车库环境卫生差，希望加强保洁	物业费
中海国际开发商不给小区单元设置门头	日常服务不到位
申请公共维修基金	申请与使用
投诉物业公厕不给开和不售卖给自己电问题"12315热线来电"	管理简单粗暴
物业服务态度不好	入户维修态度及质量差
物业提高物业费不合理	物业费
莱圳家园小区业主管理的公共收益资金一直被物业非法侵占#APP#	组织、推选
物业不经允许私自修改水电表	管理简单粗暴
希望帮助调取监控	监控实施损坏
希望到期完成投票	组织、推选
物业有黑社会性质	质量和水平
小区没有召开业主大会	组织、推选
物业乱收费	物业费
不能进京的外地车该怎么管理	秩序混乱
小区监控损坏物业不处理	监控实施损坏
协调让物业免费修缮暖气管道	自供暖社区供暖费
外窗玻璃被砸损	工作效率低
物业私自挪用维修基金	申请与使用
物业不作为的问题	日常服务不到位
小区停车位紧张问题	秩序混乱
物业乱收垃圾清运费	垃圾清运费
物业不作为	管理简单粗暴
物业不允许进入小区	物业费
物业乱收费	物业费
保安人员违规驱逐自己	保安不当行为
馨港庄园小区装修需交装修押金不合理问题	管理费
物业收维修下水道费用不合理	管理费
希望物业恢复地下停车库供电	质量和水平
隆福寺社区门前放置禁停石墩问题＃微博＃	秩序混乱
消防通道停放车辆，存在安全隐患	质量和水平
尽快协调新老物业交接让新物业进驻问题	权力运作及监督
自己能不能把电表跳过去先使用电。	态度与规范
组织成立业委会	组织、推选
老旧物业不交接、撤离问题	管理简单粗暴
来电撤销物业管理收费问题。	自供暖社区供暖费
反映没有正式的物业	权力运作及监督
私人安装摄像头影响个人隐私问题	安全秩序没保障
无法在物业购买燃气	质量和水平
安装充电桩	日常服务不到位
地下室内违章停车	安全没保障
小区停车秩序差	秩序混乱
小区管理差	管理简单粗暴
投诉小区物业恶势力	威胁恐吓业主
物业不盖章	态度与规范
小区停车收费不合理	收费不合理
停车秩序乱的问题	秩序混乱
物业清走自己自行车不合理	管理简单粗暴
家门口生活用品屡次被村里保安清走问题	管理简单粗暴
反映单位不予缴纳维修基金	申请与使用
小区物业不处理事情	质量和水平
 开发商代收公共维修基金后将此费用交到了哪个部门	缴纳与监管
希望小区安装监控	监控实施损坏
物业私自改变合同欺骗业主的问题	态度与规范
咨询圈占消防栓设施的行为的问题	安全没保障
施工的货车和铲车挡着门导致无法进小区的问题	安全没保障
物业保安威胁到业主的人身安全的问题	保安不当行为
停车管理服务不规范问题	安全没保障
物业不配合安装电动汽车充电桩问题	质量和水平
小区物业费高	物业费
玉海园小区三里小广场踢球存隐患问题#微博私信#	安全秩序没保障
村委会向外来租户收取物业管理费且未公示明细，村民认为不合理【北京市委书记蔡奇】#人民网地方领导留言板#	物业费
马驹桥胜利物业有限公司威胁市民不交物业费就停水问题	威胁恐吓业主
缴费不合理	自供暖社区供暖费
右安门外开阳里二区物业不作为	质量和水平
地坛北里11号楼楼没有安装摄像头	安全没保障
希望物业尽快处理烟道问题	质量和水平
物业胡乱作为问题	管理简单粗暴
咨询商品房物业费收费标准“12315热线来电”	物业费
保安轰人问题	保安不当行为
芍药居4号院和14号院前消防通道被车辆占用	安全没保障
希望增设停车位	场地紧张
大龙物业捆绑物业费和停车费	物业费
希望物业更换夜间红外高清摄像头问题	监控实施损坏
拆除铁桩	安全没保障
投诉物业乱收费注销电卡	管理费
北京城建畅悦居小区分为保障房区和别墅区，物业近期清除了两区之间的公共绿地，准备栽种树木对两区进行隔离，保障房区居民对此意见大	质量和水平
来电告知进展	监控实施损坏
希望能够开通小区地下停车场	秩序混乱
小区物业态度差	管理简单粗暴
社区没有通知到位导致业主分不到车位	权力运作及监督
小区物业私划停车位不合理的问题	秩序混乱
物业不作为	态度与规范
违规占用消防通道规划停车位，存在安全隐患	安全没保障
建议增设人脸识别和摄像头设施	安全秩序没保障
希望有关部门告知自己收费标准问题	物业费
物业未经业主同意涨物业费问题	物业费
力宝诗礼庭小区物业宽带垄断问题#微博#	管理简单粗暴
居民私占车位问题	秩序混乱
只能停一辆车不合理	管理费
物业胡乱收费	垃圾清运费
投诉物业公司乱作为“12315热线来电”	质量和水平
物业违规收取水费问题	管理费
业委会不作为	权力运作及监督
换物业问题	权力运作及监督
协调延长临时业主大会开会时间问题	组织、推选
希望增加摄像头	安全秩序没保障
小区单元门门禁故障，迟迟无人维修	监控实施损坏
小区公共维修基金使用问题#市政府门户网站互动交流平台#	缴纳与监管
提前收取物业费	物业费
小区无法更换物业	日常服务不到位
希望帮助协调小区业主成立业委会问题	组织、推选
协调撤销业委会	权力运作及监督
投诉兴丰派出所门口保安态度恶劣的问题	保安不当行为
投诉田村街道办事处不让延期召开业委会	受破坏及法律权益保障
玉桥街道办事处不处理车被宣传牌子刮坏不合理问题	安全没保障
小区卫生无人清理，希望及时解决	日常服务不到位
物业乱收费问题	物业费
投诉物业不作为	质量和水平
物业未经业主同意私自上涨物业费，业主对此意见大	物业费
破坏小区规章制度	受破坏及法律权益保障
违章停车	秩序混乱
反映成立业主委员会问题	组织、推选
物业不作为的问题	质量和水平
尽快帮助安装监控的问题	监控实施损坏
东升镇文龙家园一里停车问题#APP#	收费不合理
建议太平湖小区清除杂草铺地砖#微博#	日常服务不到位
物业保安到人行便道上锁车不合理	保安不当行为
物业占用小区公共道路规划停车位，影响居民出行	秩序混乱
物业按非普通住宅收取物业费用不合理	物业费
物业收取1200元钱电表费不合理	管理费
物业不给装修押金	管理费
不能网上购电不合理	质量和水平
按计划按步骤帮助各个小区成立业主委员会【北京市委书记蔡奇】#人民网地方领导留言板#	组织、推选
选举方式制度不全面	组织、推选
物业收费不合理	管理费
希望增设自行车棚	日常服务不到位
协调新物业入驻	管理简单粗暴
居委会主任成为业主委员会候选人不合理	组织、推选
物业公司针对停车收费民调方式不合理	管理简单粗暴
金隅大成物业相关人员作出处罚#市政府门户网站互动交流平台#	入户维修态度及质量差
物业收取停车费不合理问题	收费不合理
保安队长垄断快递的问题	管理费
小区停车无人管理	秩序混乱
投诉绿城物业公司暴力撬门强行清理业主东西	管理简单粗暴
排泄物无人清理	日常服务不到位
物业违规停电	管理简单粗暴
不退停车费	管理费
希望将楼道里面旧自行车挪走	秩序混乱
物业私自占据小区停车位出租问题#微博#	管理简单粗暴
停车秩序	秩序混乱
自行车车胎被划问题【北京市委书记蔡奇】#人民网地方领导留言板#	安全没保障
停车管理公司收费不合理	收费不合理
物业门禁卡收费不合理	物业费
业委会私自更换物业	组织、推选
物业不作为的问题	态度与规范
老物业骚扰业主	监控实施损坏
投诉东光物业不作为	安全秩序没保障
小区内停车秩序差	秩序混乱
投诉对物业服务态度及工作质量的不满	监控实施损坏
  物业的问题	工作效率低
路障不合理导致车无法进入小区的问题	安全没保障
地上停车场系统无法自动识别问题	安全没保障
物业不让快递进门送快递	质量和水平
怡美家园居委会及居民阻止当代城市花园小区封闭管理问题	管理简单粗暴
帮助撤销东城区的录用资料信息	态度与规范
车辆进不去小区	权力运作及监督
物业频繁给租户发短信骚扰问题	威胁恐吓业主
怀疑业委会贪污的问题	权力运作及监督
小区内堆放共享单车影响通行#微博#	秩序混乱
小区停车系统升级，导致居民无法正常停车	管理简单粗暴
保安谩骂市民	保安不当行为
希望延长半年投票成立业主委员会	组织、推选
了解装修收费标准	垃圾清运费
门禁故障无法出门	安全秩序没保障
环铁艺术区腾退问题#微博#	受破坏及法律权益保障
投诉园博园欧洲园保安#微博# 	保安不当行为
保安不让走的	保安不当行为
分配车位不合理	安全没保障
希望望京明苑小区尽快成立业委会	组织、推选
协调清理建筑垃圾及杂物	日常服务不到位
核实能否成立业委会	组织、推选
大兴区瀛海镇南海子公园保安队队长态度恶劣问题	管理简单粗暴
老业委会迟迟不交接问题	权力运作及监督
业委会成立问题	组织、推选
物业收取停车费不合理	收费不合理
物业私自把柜子搬走问题	管理简单粗暴
公示经营收益合同	权力运作及监督
物业不作为	质量和水平
希望增设社区居委会	态度与规范
迟迟未给退装修押金问题	管理费
业委会筹备负责人为居委会主任不合理的问题	组织、推选
洛娃大厦A座中控室工作人员半夜睡觉不合理的问题	质量和水平
小区加强外来人员管理	安全秩序没保障
西红门镇同兴园小区房屋物业费收取问题	物业费
小区物业在安装电梯位置安装汽车充电桩存在安全隐患	安全秩序没保障
希望加强小区治安管理	安全秩序没保障
保安不让自己出小区	日常服务不到位
小区没有居委会	权力运作及监督
开发商未经业主同意改变自行车停车库	秩序混乱
物业乱收费	管理费
北京太阳城电梯故障物业强迫业主签字动用维修基金#互联网+督察#	申请与使用
物业收取暖气不合理	自供暖社区供暖费
核实上下水改造收费是否合理	物业费
安防门被两限房业主拆的问题	威胁恐吓业主
投诉小区物业态度	态度与规范
 物业堵塞消防通道	质量和水平
投诉物业公司委托代理人频繁骚扰自己	威胁恐吓业主
物业私自涨物业费/保密	物业费
停车位收费不合理	收费不合理
不让进的问题	态度与规范
物业不作为	安全没保障
希望改成可以活动的窗	安全没保障
希望成立居委会	组织、推选
物业不作为	入户维修态度及质量差
产权单位不支付物业费	物业费
了解警察有没有调取监控视频	安全秩序没保障
建议清理灌木和杂草扩建停车位的问题	安全没保障
投诉物业管理差	管理简单粗暴
大山子环铁艺术区遣散租户不合理问题#微博#	受破坏及法律权益保障
小区只收取10号楼业主的停车费不合理	质量和水平
幼儿园不给物业费问题	管理费
镇里不给华龙小区成立业委会	组织、推选
物业管理不当	质量和水平
希望尽快修好门禁	安全秩序没保障
物业蛮横	态度与规范
停车公司到期后不撤离问题	秩序混乱
市民反映环卫领导恐吓自己的问题	威胁恐吓业主
单元门损坏	安全秩序没保障
物业建立体停车场不合理	安全没保障
公共用地改用停车场	安全没保障
居委会不给业主委会筹备组公布投票情况	组织、推选
地下车库安全设施不完善和自行车丢失未有效解决	安全没保障
物业在5单元门口划停车位影响居民出行问题	质量和水平
希望物业给2号楼安装摄像头	监控实施损坏
小区安保问题	日常服务不到位
物业收取垃圾清理费不合理问题	垃圾清运费
 保安不让市民上公共厕所	保安不当行为
小区治安管理差，近期经常丢失电动车，希望加强管理	安全秩序没保障
环卫工人不好好打扫卫生的问题	质量和水平
地下机械车位管理不到位	秩序混乱
希望相关部门协调留出能救人的过道	质量和水平
物业乱收费	管理费
协调物业清理地毯	态度与规范
柏林爱乐小区禁止安装新能源汽车充电桩#市政府门户网站互动交流平台#	态度与规范
小区申请业主委员会迟迟不给办理	组织、推选
生产石料违反国家规定	质量和水平
希望尽快纳入北京业主APP	态度与规范
只开放一个安全出口存在安全隐患	入户维修态度及质量差
开发商掐断古月家园西区15号楼1单元1002的电不合理	威胁恐吓业主
翠城小区101楼4单元单元门损坏	日常服务不到位
保安服务不到位问题	日常服务不到位
小区常驻外省居民不能参加居委会选举不合理	权力运作及监督
龙潭街道不愿意变更停车管理公司	安全没保障
小区内25E住户扰民	安全秩序没保障
单元门洞损坏无人处理的问题	日常服务不到位
自来水龙头无人更换	入户维修态度及质量差
市民反映保安把自己的车推走	保安不当行为
新旧物业迟迟未交接	组织、推选
协调成立业委会	组织、推选
物业不作为	管理简单粗暴
安乐家园私占车位#微博私信#	安全没保障
物业不给赔偿金	物业费
古桥物业公司公示支出明细费用的问题	缴纳与监管
业委会主任滥用职权	权力运作及监督
私自车位	秩序混乱
外来车辆随意进入小区，希望物业加强管理	日常服务不到位
西砂西区公租房的保安不作为	保安不当行为
房山区韩村河镇雅苑小区物业乱收费	物业费
护栏存在断裂隐患	缴纳与监管
物业没有作为	入户维修态度及质量差
希望小区加强保安监管	安全秩序没保障
投诉物业乱收费	垃圾清运费
小区停车场收取停车费不合理，居民对此意见大	收费不合理
邻居晚上敲墙噪声扰民，影响周边居民休息	安全秩序没保障
小区里停车没有固定停车位还要收取费用不合理	收费不合理
消防通道被规划成停车位	安全没保障
物业保安辱骂业主	保安不当行为
小区部分居民无法显示住房公共维修基金问题	缴纳与监管
物业私自提取维修基金问题	管理简单粗暴
外来物业强行进住小区	威胁恐吓业主
物业态度	态度与规范
物业不让进小区问题	质量和水平
海开把古月园小区地下车库电机线剪断问题	态度与规范
不交物业费是否有违约金	物业费
收垃圾清运费高不合理	垃圾清运费
邻居私自占据楼道	态度与规范
投诉美玲冰箱售后服务网点不管维修	入户维修态度及质量差
物业做法有问题	管理简单粗暴
协调退款	垃圾清运费
希望治理小区治理停车秩序混乱问题	秩序混乱
核实朝新嘉园二区物业是否具备停车收费资质	安全没保障
物业服务态度不好	态度与规范
物业未经业主同意违规动用公共维修基金维修消防通道	申请与使用
希望尽快改造停车棚	安全没保障
反映停车费不合理	管理简单粗暴
黑物业没有资质问题	态度与规范
幸福家园2号院物业不作为“12319热线来电”	日常服务不到位
投诉物业多收水费	管理费
物业私自收取垃圾清运费1500元钱不合理/保密	垃圾清运费
车辆被划物业无人处理问题	安全没保障
通州区住建委物业科不作为	入户维修态度及质量差
物业起诉自己	物业费
物业私自涨停车费不合理	管理费
小区业委会私自挪用公共维修基金，希望查处	缴纳与监管
车在路边被锁了	安全没保障
物业收取装修费不合理问题	管理费
使用公共维修基金维修电梯不合理	申请与使用
东亚马赛公馆小区没有业委会	组织、推选
小区不能装充电桩的问题	安全没保障
不允许市民租户进屋	受破坏及法律权益保障
公司接受黑户人员	保安不当行为
保安态度恶劣问题	保安不当行为
停车场迟迟未完工	安全没保障
希望小区增设门卫	日常服务不到位
中关村南大街5号院停车收费不合理的问题	收费不合理
富力慧兰美居没有居委会	权力运作及监督
协调尽快协调扩电容	申请与使用
小区物业部退装修押金	管理费
物业不同意业主自行出钱更换电表不合理	态度与规范
门禁损坏无人维修	安全秩序没保障
关于停车规划问题	组织、推选
道路坑洼积水无人管理	工作效率低
物业不作为	态度与规范
物业更换水卡条件不合理	态度与规范
协调鼎大物业打开枣园尚城南区北门	管理简单粗暴
物业乱作为	态度与规范
物业强行封闭小区收取市民物业费问题	物业费
物业迟迟不给解决室外机被占用问题	管理简单粗暴
居委会收取停车费不合理	缴纳与监管
核实交物业费是否需要交税	物业费
政府可以成立一个网上平台进行投票	权力运作及监督
居民楼内经营扰民问题	安全秩序没保障
开发商不作为问题	管理简单粗暴
小区监控停用	监控实施损坏
希望物业先公示施工方案与费用明细再施工	管理费
物业行为不合理	质量和水平
保安态度问题	保安不当行为
金地物业乱收门禁卡费“12315热线来电”	管理费
地下停车库停车没有安全保障	安全没保障
反映希望核实维修基金是否启用问题	申请与使用
开墙打洞	安全秩序没保障
拆迁后未退回维修基金	申请与使用
公共楼道里安装防盗门	安全秩序没保障
可以尽快建立业委会	组织、推选
小区治安管理混乱	日常服务不到位
收取物业费不合理	物业费
像头维修的问题。	监控实施损坏
小区保安随意扣留自己车辆乱收停车费	保安不当行为
小区内的监控未开放问题	监控实施损坏
街道阻挠不让业主成立业委会不合理	组织、推选
不提供房产证和身份证复印件不给钥匙不合理问题	管理简单粗暴
自家马桶水阀损坏找物业帮忙更换，换好后物业收取安装费，市民认为不合理	管理费
业主家窗户玻璃脱落，将居民车辆砸坏，迟迟无人处理	质量和水平
小区无门禁有安全隐患	安全秩序没保障
建议在兴盛街187号院小区电梯内安装监控	监控实施损坏
小区保安不作为	保安不当行为
协调劲松街道监控中心尽快查看监控	监控实施损坏
永泰小区东里物业管理差【北京市委书记蔡奇】#人民网地方领导留言板#	工作效率低
小区保安不让搬家车出入问题#微博#	保安不当行为
咨询查询房屋大修基金	申请与使用
防盗门无人维修	质量和水平
物业不作为问题	态度与规范
业委会无人监管	权力运作及监督
小区停车位混乱	秩序混乱
小区内没有业委会，希望协调成立	组织、推选
投诉物业安装路灯不符合要求的问题	入户维修态度及质量差
物业不履行职责	秩序混乱
物业不予退还装修押金的问题	管理费
安全没有保障	安全秩序没保障
乱收费	管理费
物业收取中水费用不合理	物业费
小区管理差(大风)	质量和水平
医院内停车秩序乱	秩序混乱
督办银行卡解冻	权力运作及监督
美甲店里没有监控	监控实施损坏
对物业封7号楼西侧出入口不认可问题	管理简单粗暴
居委会要求业主的户口在本小区车辆才可以进入小区不合理	安全没保障
物业服务不到位，业主维权难，希望成立业委会	组织、推选
老旧物业迟迟不撤离	日常服务不到位
永顺镇镇政府不作为问题	申请与使用
小区新换的手机扫码的电子门不认可，希望换回原样门	态度与规范
物业不给维修卫生间防水#市政府门户网站互动交流平台#	入户维修态度及质量差
业委会将小区绿化道路出租给停车公司#微博私信#	受破坏及法律权益保障
物业对地上车位收费不合理	物业费
投诉对物业服务态度及工作质量的不满	监控实施损坏
物业不作为	物业费
小区两个区域之间铁门存在安全隐患/保密	安全秩序没保障
物业打人	管理简单粗暴
小区门不关存在安全隐患的问题	管理简单粗暴
现业委会阻挠小区居民改选业委会	质量和水平
投诉物业不作为	日常服务不到位
小区物业收费高问题	物业费
物业未经业主同意，违规动用公共维修基金维修消防通道，居民对此意见大/保密	管理简单粗暴
投诉物业费收费不合理	物业费
溪城家园小区停车管理单位不作为	安全没保障
主管道维修业主自己掏钱不合理	权力运作及监督
维修防盗门问题	监控实施损坏
小区停车秩序混乱	秩序混乱
地下车库被出租给饭店不合理	秩序混乱
增设摄像头	监控实施损坏
楼道灯不亮	日常服务不到位
小区停车秩序混乱	秩序混乱
物业强制断电问题	管理简单粗暴
新更换自来水管道，希望对于管道质量进行检测	缴纳与监管
小区物业不收取按小时临时停车费问题	收费不合理
莱圳家园小区业主管理的公共收益资金一直被物业非法侵占#APP#	组织、推选
物业不作为	入户维修态度及质量差
物业阻止底商悬挂广告牌不合理，底商对此意见大	管理简单粗暴
摄像头故障无人维修	监控实施损坏
小区内监控不能使用	监控实施损坏
物业费不合理的问题	物业费
楼道灯不亮	入户维修态度及质量差
希望成立业主委员会问题	组织、推选
活动中心改革不认可	质量和水平
约束物业管理问题	态度与规范
毛纺南小区乱占车位问题	秩序混乱
不让小区封闭不合理	安全没保障
投诉房主恐吓市民	威胁恐吓业主
修外围墙用公共维修基金不合理	申请与使用
更改信息	权力运作及监督
赵丁海作为小区保安不合理\保密	保安不当行为
小区物业让保安拦车不合理问题	管理简单粗暴
自如平台不帮助查询情况 	监控实施损坏
投诉小区物业不作为	入户维修态度及质量差
小区没有保安	安全秩序没保障
小区无人管理导致社会车辆进入小区停车	安全没保障
小区内车辆乱停乱放无人管理问题	秩序混乱
希望在小区内部道路增设座椅的问题	质量和水平
希望小区成立业主委员会和居委会	组织、推选
希望街道帮助协调开业主大会重组业委会	组织、推选
小区物业租黑环卫	态度与规范
物业不作为问题	质量和水平
物业不开天窗的问题	管理简单粗暴
开发商不交房	质量和水平
要求物业公示收支情况	物业费
物业不让在小区停车库内安装充电桩	日常服务不到位
大平物业合同到期迟迟未撤走问题#市政府门户网站互动交流平台#	权力运作及监督
麦当劳客服人员服务态度不好	态度与规范
希望协调物业退大修费和中修费	物业费
街道居民科不作为	管理简单粗暴
核实小区物业费是否合理	物业费
物业不作为	日常服务不到位
减速带破损存在安全隐患“6310热线来电”	安全秩序没保障
停车场设置西南门出不合理的问题	安全没保障
公租房与商品房合并不合理	组织、推选
物业强制断水电，影响居民正常生活	管理简单粗暴
老物业公司霸占小区车库，导致新物业无法开展工作	权力运作及监督
建议小区尽快修复门禁系统	申请与使用
街道办事处尽快落实业委会备案	权力运作及监督
私家车占用停车位	安全没保障
核实何时给老旧小区安装电梯的问题	申请与使用
小区环境脏乱差	垃圾清运费
小区内挖大坑建设地下停车场存在安全隐患的问题	安全没保障
物业保安服务差	保安不当行为
现来电反映物业不给调监控的问题	监控实施损坏
监控损坏无人维修	监控实施损坏
把地下车库改成收费停车场不合理问题。	质量和水平
物业不卖水电	管理简单粗暴
小区停车秩序差	秩序混乱
希望成立业主委员会	组织、推选
楼道内堆放箱子存在安全隐患	日常服务不到位
北燃热力工作人员态度恶劣问题	态度与规范
小区内停车秩序差	安全秩序没保障
协调物业接电源	安全没保障
物业工程部经理乱收费	入户维修态度及质量差
小区物业乱收费的问题	物业费
物业乱收费的问题	缴纳与监管
中门寺南坡小区乱停车问题#微博#	秩序混乱
物业收取装修押金安照%几收取	管理费
金隅汇星苑物业收取垃圾处理费未开发票是否合理#评论#	垃圾清运费
村里没有监控存在安全隐患	监控实施损坏
小区保安收费不合理	保安不当行为
希望恢复摄像头（架空线入地）	监控实施损坏
申请安装监控探头	监控实施损坏
在箱子前面停放车辆影响居民使用	秩序混乱
投诉保安不让业主进小区	保安不当行为
物业管理差	秩序混乱
外侧围栏被拆不合理	安全没保障
小区内环境差无人清理	态度与规范
物业停车收费不合理问题	管理费
投诉物业管理简单粗暴问题	物业费
管理车辆停在窗户下扰民希望弄上绿化带问题	秩序混乱
在小区内规划停车位	安全没保障
甘露园南里一社区居委会不处理甘露园南里一区私占车位的问题不作为	秩序混乱
隔离桩占用消防通道存在安全隐患	日常服务不到位
擅自拉接电线给车充电问题	质量和水平
保安态度恶劣物业不进行管理	质量和水平
来电反映小区门禁损坏无人修理。	日常服务不到位
保安不让进家具	保安不当行为
保安不作为	保安不当行为
物业收费不合理	物业费
都会华庭小区地下车库收取费用不合理问题	收费不合理
咨询物业收费是否有依据	缴纳与监管
檀城西区小区业主委员会违反规定不召开业主大会	受破坏及法律权益保障
核实望都家园小区物业收取上述费用是否合理	垃圾清运费
永翌公馆1、2号楼楼顶进行大修是否合法	缴纳与监管
大兴区枣园东里车辆停在人行道上	秩序混乱
物业收取的停车费不合理	管理费
供暖单位推脱不处理	质量和水平
物业收取门禁费用不合理	管理费
电梯坏了无人修理	申请与使用
不允许开消防通道小门	安全秩序没保障
成立小区业委会成立	组织、推选
希望帮助核实垃圾费收费规定	垃圾清运费
咨询物业缴费问题	物业费
 物业在自己停车位上放石头	安全没保障
物业日常管理不到位	日常服务不到位
小区居民掌控筹备业主委员会	权力运作及监督
装充电桩	态度与规范
未经业主同意私自收取停车费不合理的问题	物业费
物业乱收费/保密	自供暖社区供暖费
收取物业费不合理	物业费
